Player,date_fix,player_7d_minutes_practice,player_14d_minutes_practice,player_28d_minutes_practice,player_7d_srpe_100_practice,player_14d_srpe_100_practice,player_28d_srpe_100_practice,player_7d_minutes_4_game,player_14d_minutes_4_game,player_28d_minutes_4_game,player_7d_srpe_100_game,player_14d_srpe_100_game,player_28d_srpe_100_game,player_7d_total_srpe_100,player_14d_total_srpe_100,player_28d_total_srpe_100,player_7d_total_min,player_14d_total_min,player_28d_total_min
Elias Rapieque,2024-08-20,120,120,120,12,40,80,0,0,0,0,0,0,12,40,80,120,120,120
Elias Rapieque,2024-08-21,255,255,255,43,102,189,0,0,0,0,0,0,43,102,189,255,255,255
Elias Rapieque,2024-08-22,390,390,390,94,183,316,0,0,0,0,0,0,94,183,316,390,390,390
Elias Rapieque,2024-08-23,490,490,490,152,265,431,0,0,0,0,0,0,152,265,431,490,490,490
Elias Rapieque,2024-08-24,610,610,610,214,378,586,0,0,0,0,0,0,214,378,586,610,610,610
Elias Rapieque,2024-08-25,790,790,790,371,521,853,0,0,0,0,0,0,371,521,853,790,790,790
Elias Rapieque,2024-08-27,790,910,910,387,537,1056,0,0,0,0,0,0,387,537,1056,790,910,910
Elias Rapieque,2024-08-28,855,1110,1110,462,788,1421,0,0,0,0,0,0,462,788,1421,855,1110,1110
Elias Rapieque,2024-08-30,745,1235,1235,358,976,1618,0,0,0,0,0,0,358,976,1618,745,1235,1235
Elias Rapieque,2024-08-31,735,1345,1345,338,1089,1735,0,0,0,0,0,0,338,1089,1735,735,1345,1345
Elias Rapieque,2024-09-01,555,1345,1345,189,1089,1627,240,240,240,14,14,14,203,1104,1642,795,1585,1585
Elias Rapieque,2024-09-03,535,1325,1445,214,1179,1763,240,240,240,14,14,14,228,1194,1777,775,1565,1685
Elias Rapieque,2024-09-04,455,1310,1565,155,1153,2003,240,240,240,14,14,14,169,1167,2018,695,1550,1805
Elias Rapieque,2024-09-05,575,1295,1685,236,1140,2275,240,240,240,14,14,14,250,1154,2289,815,1535,1925
Elias Rapieque,2024-09-06,555,1300,1790,211,1118,2506,240,240,240,14,14,14,225,1132,2520,795,1540,2030
Elias Rapieque,2024-09-07,505,1240,1850,177,1004,2646,260,260,260,23,23,23,200,1028,2669,765,1500,2110
Elias Rapieque,2024-09-09,610,1165,1955,256,885,2639,20,260,260,1,23,23,257,909,2663,630,1425,2215
Elias Rapieque,2024-09-10,600,1135,2045,216,863,2761,20,260,260,1,23,23,217,886,2784,620,1395,2305
Elias Rapieque,2024-09-11,480,935,2045,178,664,2904,20,260,260,1,23,23,178,687,2927,500,1195,2305
Elias Rapieque,2024-09-12,420,995,2105,139,736,3052,76,316,316,8,51,51,146,787,3103,496,1311,2421
Elias Rapieque,2024-09-13,365,920,2155,113,635,3189,132,372,372,22,86,86,136,720,3275,497,1292,2527
Elias Rapieque,2024-09-14,365,870,2215,128,609,3345,112,372,372,16,86,86,143,695,3430,477,1242,2587
Elias Rapieque,2024-09-15,365,870,2215,128,609,3345,184,204,444,39,49,133,166,658,3478,549,1074,2659
Elias Rapieque,2024-09-17,285,885,2210,77,558,3359,184,204,444,39,49,133,116,607,3492,469,1089,2654
Elias Rapieque,2024-09-18,410,890,2200,119,587,3388,184,204,444,39,49,133,158,636,3521,594,1094,2644
Elias Rapieque,2024-09-19,524,944,2239,278,812,3896,128,204,444,18,49,133,296,861,4029,652,1148,2683
Elias Rapieque,2024-09-20,586,951,2251,346,856,3962,72,204,444,5,49,133,351,905,4095,658,1155,2695
Elias Rapieque,2024-09-21,600,965,2205,348,897,3837,72,184,444,5,39,133,353,936,3970,672,1149,2649
Elias Rapieque,2024-09-22,600,965,2025,360,917,3321,44,228,488,3,62,176,363,978,3497,644,1193,2513
Elias Rapieque,2024-09-24,570,855,1990,348,752,3264,44,228,488,3,62,176,350,814,3439,614,1083,2478
Elias Rapieque,2024-09-25,548,958,1893,334,862,3048,44,228,488,3,62,176,337,924,3223,592,1186,2381
Elias Rapieque,2024-09-26,464,988,1983,200,948,3371,44,172,488,3,34,176,202,983,3547,508,1160,2471
Elias Rapieque,2024-09-27,352,938,1858,120,872,3010,44,116,488,3,15,176,122,887,3186,396,1054,2346
Elias Rapieque,2024-09-28,322,922,1792,113,857,2921,76,148,520,8,27,213,121,884,3134,398,1070,2312
Elias Rapieque,2024-09-30,437,1037,1907,162,1006,3185,32,76,280,2,8,98,163,1014,3283,469,1113,2187
Elias Rapieque,2024-10-01,450,1020,1905,171,1010,3086,32,76,280,2,8,98,173,1018,3184,482,1096,2185
Elias Rapieque,2024-10-02,438,986,1876,188,1025,3189,32,76,280,2,8,98,190,1034,3287,470,1062,2156
Elias Rapieque,2024-10-03,399,863,1807,148,690,3000,32,76,280,2,8,98,149,699,3098,431,939,2087
Elias Rapieque,2024-10-04,399,751,1702,148,533,2740,76,120,324,8,20,133,156,554,2873,475,871,2026
Elias Rapieque,2024-10-05,439,761,1726,154,533,2813,44,120,304,3,20,116,156,553,2929,483,881,2030
Elias Rapieque,2024-10-06,439,761,1726,154,517,2813,88,120,348,11,20,153,164,538,2967,527,881,2074
Elias Rapieque,2024-10-08,309,759,1614,87,501,2486,88,120,348,11,20,153,97,521,2639,397,879,1962
Elias Rapieque,2024-10-09,314,752,1710,91,541,2770,88,120,348,11,20,153,102,562,2923,402,872,2058
Elias Rapieque,2024-10-10,344,743,1731,103,498,2822,88,120,292,11,20,108,114,518,2930,432,863,2023
Elias Rapieque,2024-10-11,389,788,1726,140,575,2865,84,160,276,8,34,94,148,609,2959,473,948,2002
Elias Rapieque,2024-10-12,356,795,1717,132,572,2833,84,128,276,8,20,94,140,593,2927,440,923,1993
Elias Rapieque,2024-10-13,356,795,1717,132,572,2833,96,184,260,11,42,88,142,615,2921,452,979,1977
Elias Rapieque,2024-10-14,396,720,1757,150,497,2917,96,184,260,11,42,88,161,539,3005,492,904,2017
Elias Rapieque,2024-10-15,355,664,1684,124,418,2728,96,184,260,11,42,88,135,461,2816,451,848,1944
Elias Rapieque,2024-10-16,259,573,1559,52,281,2385,96,184,260,11,42,88,62,323,2474,355,757,1819
Elias Rapieque,2024-10-17,225,569,1432,43,279,1847,96,184,260,11,42,88,53,321,1936,321,753,1692
Elias Rapieque,2024-10-19,129,485,1246,9,213,1420,56,140,260,4,24,88,13,237,1509,185,625,1506
Elias Rapieque,2024-10-20,129,485,1246,9,213,1396,0,96,216,0,11,60,9,224,1456,129,581,1462
Elias Rapieque,2024-10-22,47,402,1161,1,153,1207,0,96,216,0,11,60,1,163,1268,47,498,1377
Elias Rapieque,2024-10-23,47,306,1058,1,70,1005,0,96,216,0,11,60,1,81,1066,47,402,1274
Elias Rapieque,2024-10-24,0,225,968,0,43,832,0,96,216,0,11,60,0,53,893,0,321,1184
Gabriele Procida,2024-08-20,120,120,120,10,10,10,0,0,0,0,0,0,10,10,10,120,120,120
Gabriele Procida,2024-08-21,255,255,255,41,41,41,0,0,0,0,0,0,41,41,41,255,255,255
Gabriele Procida,2024-08-22,255,255,255,41,41,41,0,0,0,0,0,0,41,41,41,255,255,255
Gabriele Procida,2024-08-23,345,345,345,79,79,79,0,0,0,0,0,0,79,79,79,345,345,345
Gabriele Procida,2024-08-24,465,465,465,144,144,144,0,0,0,0,0,0,144,144,144,465,465,465
Gabriele Procida,2024-08-25,555,555,555,205,205,205,0,0,0,0,0,0,205,205,205,555,555,555
Gabriele Procida,2024-08-27,555,675,675,200,297,297,0,0,0,0,0,0,200,297,297,555,675,675
Gabriele Procida,2024-08-28,620,875,875,242,481,481,0,0,0,0,0,0,242,481,481,620,875,875
Gabriele Procida,2024-08-30,655,1000,1000,255,620,620,0,0,0,0,0,0,255,620,620,655,1000,1000
Gabriele Procida,2024-08-31,645,1110,1110,239,755,755,0,0,0,0,0,0,239,755,755,645,1110,1110
Gabriele Procida,2024-09-01,555,1110,1110,172,755,755,240,240,240,17,17,17,189,772,772,795,1350,1350
Gabriele Procida,2024-09-03,445,1000,1120,138,670,840,240,240,240,17,17,17,155,687,857,685,1240,1360
Gabriele Procida,2024-09-04,245,865,1120,49,510,840,240,240,240,17,17,17,66,527,857,485,1105,1360
Gabriele Procida,2024-09-05,245,865,1120,49,510,840,240,240,240,17,17,17,66,527,857,485,1105,1360
Gabriele Procida,2024-09-06,120,775,1120,16,403,840,240,240,240,17,17,17,32,420,857,360,1015,1360
Gabriele Procida,2024-09-07,10,655,1120,1,288,840,240,240,240,17,17,17,18,305,857,250,895,1360
Gabriele Procida,2024-09-09,100,655,1210,12,282,968,0,240,240,0,17,17,12,298,985,100,895,1450
Gabriele Procida,2024-09-10,180,625,1300,20,263,1118,0,240,240,0,17,17,20,279,1135,180,865,1540
Gabriele Procida,2024-09-11,180,425,1300,29,153,1183,0,240,240,0,17,17,29,170,1200,180,665,1540
Gabriele Procida,2024-09-12,240,485,1360,46,189,1278,72,312,312,4,41,41,50,230,1319,312,797,1672
Gabriele Procida,2024-09-13,290,410,1410,64,144,1368,164,404,404,23,85,85,87,228,1453,454,814,1814
Gabriele Procida,2024-09-15,290,300,1410,64,87,1368,252,252,492,55,55,143,119,142,1510,542,552,1902
Gabriele Procida,2024-09-17,225,405,1405,41,117,1349,252,252,492,55,55,143,96,173,1491,477,657,1897
Gabriele Procida,2024-09-18,350,530,1395,74,196,1339,252,252,492,55,55,143,129,252,1482,602,782,1887
Gabriele Procida,2024-09-19,404,644,1509,97,277,1539,180,252,492,29,55,143,126,332,1682,584,896,2001
Gabriele Procida,2024-09-20,466,756,1531,130,378,1562,88,252,492,7,55,143,138,433,1704,554,1008,2023
Gabriele Procida,2024-09-21,492,782,1437,148,407,1380,88,252,492,7,55,143,155,462,1522,580,1034,1929
Gabriele Procida,2024-09-22,492,782,1347,148,407,1212,0,252,492,0,55,143,148,462,1355,492,1034,1839
Gabriele Procida,2024-09-24,377,602,1227,87,247,1018,0,252,492,0,55,143,87,302,1161,377,854,1719
Gabriele Procida,2024-09-25,252,602,1027,38,217,739,0,252,492,0,55,143,38,272,882,252,854,1519
Gabriele Procida,2024-09-26,138,542,1027,12,179,739,0,180,492,0,29,143,12,208,882,138,722,1519
Gabriele Procida,2024-09-27,26,492,902,1,148,586,0,88,492,0,7,143,1,155,729,26,580,1394
Gabriele Procida,2024-09-28,44,536,836,3,193,543,0,88,492,0,7,143,3,200,686,44,624,1328
Gabriele Procida,2024-09-30,159,651,951,19,273,675,0,0,252,0,0,55,19,273,731,159,651,1203
Gabriele Procida,2024-10-01,234,611,1016,40,244,701,0,0,252,0,0,55,40,244,756,234,611,1268
Gabriele Procida,2024-10-02,234,486,1016,40,156,701,0,0,252,0,0,55,40,156,756,234,486,1268
Gabriele Procida,2024-10-03,285,423,1067,66,135,800,0,0,252,0,0,55,66,135,856,285,423,1319
Gabriele Procida,2024-10-04,285,311,1067,66,78,800,480,480,732,34,34,212,99,111,1013,765,791,1799
Gabriele Procida,2024-10-05,271,315,1097,62,91,889,480,480,732,34,34,212,96,125,1101,751,795,1829
Gabriele Procida,2024-10-06,271,315,1097,62,91,889,480,480,732,34,34,212,96,125,1101,751,795,1829
Gabriele Procida,2024-10-08,149,383,985,24,126,729,480,480,732,34,34,212,57,160,941,629,863,1717
Gabriele Procida,2024-10-09,250,484,1086,70,218,880,480,480,732,34,34,212,104,251,1092,730,964,1818
Gabriele Procida,2024-10-10,295,580,1122,97,325,999,480,480,660,34,34,152,131,358,1150,775,1060,1782
Gabriele Procida,2024-10-11,340,625,1117,133,388,1028,44,524,612,3,73,135,136,461,1162,384,1149,1729
Gabriele Procida,2024-10-12,361,632,1168,141,392,1145,44,524,612,3,73,135,144,465,1279,405,1156,1780
Gabriele Procida,2024-10-13,361,632,1168,141,392,1145,44,524,524,3,73,73,144,465,1218,405,1156,1692
Gabriele Procida,2024-10-14,446,602,1253,227,409,1378,44,524,524,3,73,73,231,483,1452,490,1126,1777
Gabriele Procida,2024-10-15,420,569,1180,210,376,1251,104,584,584,16,128,128,226,504,1379,524,1153,1764
Gabriele Procida,2024-10-16,369,619,1105,151,427,1116,104,584,584,16,128,128,167,556,1245,473,1203,1689
Gabriele Procida,2024-10-17,320,615,1038,106,406,1017,120,600,600,22,150,150,127,556,1167,440,1215,1638
Gabriele Procida,2024-10-19,286,647,962,74,421,904,76,120,600,8,22,150,83,442,1054,362,767,1562
Gabriele Procida,2024-10-20,286,647,962,74,421,904,128,172,652,24,45,215,99,465,1119,414,819,1614
Gabriele Procida,2024-10-21,241,687,1002,48,488,1002,128,172,652,24,45,215,73,532,1217,369,859,1654
Gabriele Procida,2024-10-22,308,728,1111,99,597,1278,68,172,652,7,45,215,106,642,1493,376,900,1763
Gabriele Procida,2024-10-23,346,715,1199,149,601,1547,68,172,652,7,45,215,156,645,1762,414,887,1851
Gabriele Procida,2024-10-24,350,670,1250,161,529,1688,292,412,892,44,136,357,205,665,2044,642,1082,2142
Jonas Mattisseck,2024-08-20,120,120,120,11,26,47,0,0,0,0,0,0,11,26,47,120,120,120
Jonas Mattisseck,2024-08-21,255,255,255,38,71,115,0,0,0,0,0,0,38,71,115,255,255,255
Jonas Mattisseck,2024-08-22,390,390,390,90,140,207,0,0,0,0,0,0,90,140,207,390,390,390
Jonas Mattisseck,2024-08-23,490,490,490,123,211,294,0,0,0,0,0,0,123,211,294,490,490,490
Jonas Mattisseck,2024-08-24,610,610,610,201,311,415,0,0,0,0,0,0,201,311,415,610,610,610
Jonas Mattisseck,2024-08-25,790,790,790,332,435,608,0,0,0,0,0,0,332,435,608,790,790,790
Jonas Mattisseck,2024-08-27,790,910,910,340,473,746,0,0,0,0,0,0,340,473,746,790,910,910
Jonas Mattisseck,2024-08-28,855,1110,1110,402,688,1021,0,0,0,0,0,0,402,688,1021,855,1110,1110
Jonas Mattisseck,2024-08-30,745,1235,1235,291,790,1173,0,0,0,0,0,0,291,790,1173,745,1235,1235
Jonas Mattisseck,2024-08-31,735,1345,1345,257,915,1332,0,0,0,0,0,0,257,915,1332,735,1345,1345
Jonas Mattisseck,2024-09-01,555,1345,1345,144,915,1278,240,240,240,17,17,17,161,931,1295,795,1585,1585
Jonas Mattisseck,2024-09-03,535,1325,1445,182,1020,1431,240,240,240,17,17,17,199,1037,1447,775,1565,1685
Jonas Mattisseck,2024-09-04,455,1310,1565,137,1009,1643,240,240,240,17,17,17,153,1026,1660,695,1550,1805
Jonas Mattisseck,2024-09-05,575,1295,1685,201,958,1854,240,240,240,17,17,17,218,975,1870,815,1535,1925
Jonas Mattisseck,2024-09-06,555,1300,1790,189,949,2076,240,240,240,17,17,17,206,966,2093,795,1540,2030
Jonas Mattisseck,2024-09-07,505,1240,1850,167,843,2202,324,324,324,39,39,39,206,882,2240,829,1564,2174
Jonas Mattisseck,2024-09-09,610,1165,1955,232,746,2326,84,324,324,4,39,39,236,784,2365,694,1489,2279
Jonas Mattisseck,2024-09-10,600,1135,2045,198,760,2434,84,324,324,4,39,39,202,799,2472,684,1459,2369
Jonas Mattisseck,2024-09-11,480,935,2045,154,580,2536,84,324,324,4,39,39,158,619,2575,564,1259,2369
Jonas Mattisseck,2024-09-12,420,995,2105,126,647,2673,96,336,336,8,50,50,134,697,2724,516,1331,2441
Jonas Mattisseck,2024-09-13,315,870,2105,76,505,2568,96,336,336,8,50,50,83,555,2619,411,1206,2441
Jonas Mattisseck,2024-09-15,255,760,2105,54,410,2568,12,96,336,0,8,50,54,418,2619,267,856,2441
Jonas Mattisseck,2024-09-17,60,660,1985,5,271,2342,12,96,336,0,8,50,5,278,2393,72,756,2321
Jonas Mattisseck,2024-09-18,60,540,1850,2,189,2072,12,96,336,0,8,50,2,197,2122,72,636,2186
Jonas Mattisseck,2024-09-19,62,482,1777,1,154,1884,0,96,336,0,8,50,1,162,1934,62,578,2113
Jonas Mattisseck,2024-09-20,132,447,1747,9,139,1817,0,96,336,0,8,50,9,146,1867,132,543,2083
Jonas Mattisseck,2024-09-21,206,461,1701,27,157,1735,0,12,336,0,0,50,27,157,1785,206,473,2037
Jonas Mattisseck,2024-09-22,206,461,1521,31,166,1445,68,80,404,4,7,85,35,173,1530,274,541,1925
Jonas Mattisseck,2024-09-24,291,351,1486,64,105,1441,68,80,404,4,7,85,68,113,1526,359,431,1890
Jonas Mattisseck,2024-09-25,394,454,1389,114,145,1306,68,80,404,4,7,85,118,152,1391,462,534,1793
Jonas Mattisseck,2024-09-26,422,484,1479,143,174,1494,68,68,404,4,4,85,148,178,1579,490,552,1883
Jonas Mattisseck,2024-09-27,417,549,1419,142,225,1405,68,68,404,4,4,85,146,229,1490,485,617,1823
Jonas Mattisseck,2024-09-28,387,593,1353,128,273,1353,168,168,504,20,20,136,148,293,1489,555,761,1857
Jonas Mattisseck,2024-09-30,387,593,1353,120,273,1353,100,168,264,6,20,53,126,293,1406,487,761,1617
Jonas Mattisseck,2024-10-01,400,691,1351,120,359,1256,100,168,264,6,20,53,126,379,1309,500,859,1615
Jonas Mattisseck,2024-10-02,373,767,1307,104,437,1202,100,168,264,6,20,53,110,457,1255,473,935,1571
Jonas Mattisseck,2024-10-03,334,756,1238,80,438,1114,100,168,264,6,20,53,86,459,1167,434,924,1502
Jonas Mattisseck,2024-10-04,269,686,1133,51,364,952,184,252,348,26,50,97,77,414,1049,453,938,1481
Jonas Mattisseck,2024-10-05,309,696,1157,56,355,983,84,252,264,7,50,61,62,405,1044,393,948,1421
Jonas Mattisseck,2024-10-06,309,696,1157,56,341,983,176,276,356,26,58,107,82,399,1090,485,972,1513
Jonas Mattisseck,2024-10-08,211,611,962,25,257,693,176,276,356,26,58,107,52,315,799,387,887,1318
Jonas Mattisseck,2024-10-09,216,589,1043,22,224,730,176,276,356,26,58,107,48,282,837,392,865,1399
Jonas Mattisseck,2024-10-10,246,580,1064,32,215,777,176,276,344,26,58,93,58,273,870,422,856,1408
Jonas Mattisseck,2024-10-11,291,560,1109,52,207,865,100,284,352,9,65,102,61,273,967,391,844,1461
Jonas Mattisseck,2024-10-12,258,567,1160,49,210,963,100,184,352,9,31,102,58,241,1065,358,751,1512
Jonas Mattisseck,2024-10-13,258,567,1160,49,210,963,80,256,424,6,56,144,55,266,1107,338,823,1584
Jonas Mattisseck,2024-10-14,298,607,1200,63,237,1020,80,256,424,6,56,144,68,293,1164,378,863,1624
Jonas Mattisseck,2024-10-15,340,551,1242,82,198,1093,144,320,488,19,90,195,100,288,1288,484,871,1730
Jonas Mattisseck,2024-10-16,309,525,1292,74,179,1176,144,320,488,19,90,195,93,268,1371,453,845,1780
Jonas Mattisseck,2024-10-17,275,521,1277,58,177,1175,188,364,532,34,120,239,92,297,1414,463,885,1809
Jonas Mattisseck,2024-10-19,241,499,1195,36,170,1016,180,280,532,29,70,239,65,240,1255,421,779,1727
Jonas Mattisseck,2024-10-20,241,499,1195,36,170,992,180,260,536,32,65,247,69,235,1238,421,759,1731
Jonas Mattisseck,2024-10-22,273,613,1224,55,270,1053,116,260,536,14,65,247,69,335,1299,389,873,1760
Jonas Mattisseck,2024-10-23,311,620,1209,87,322,1088,116,260,536,14,65,247,101,387,1335,427,880,1745
Jonas Mattisseck,2024-10-24,315,590,1170,95,301,1030,312,500,776,37,150,396,132,451,1425,627,1090,1946
Justin Bean,2024-08-20,120,120,120,7,7,7,0,0,0,0,0,0,7,7,7,120,120,120
Justin Bean,2024-08-21,255,255,255,38,38,38,0,0,0,0,0,0,38,38,38,255,255,255
Justin Bean,2024-08-22,390,390,390,86,86,86,0,0,0,0,0,0,86,86,86,390,390,390
Justin Bean,2024-08-23,490,490,490,132,132,132,0,0,0,0,0,0,132,132,132,490,490,490
Justin Bean,2024-08-24,610,610,610,214,214,214,0,0,0,0,0,0,214,214,214,610,610,610
Justin Bean,2024-08-25,790,790,790,379,379,379,0,0,0,0,0,0,379,379,379,790,790,790
Justin Bean,2024-08-27,790,910,910,395,510,510,0,0,0,0,0,0,395,510,510,790,910,910
Justin Bean,2024-08-28,855,1110,1110,462,766,766,0,0,0,0,0,0,462,766,766,855,1110,1110
Justin Bean,2024-08-30,745,1235,1235,365,939,939,0,0,0,0,0,0,365,939,939,745,1235,1235
Justin Bean,2024-08-31,735,1345,1345,345,1103,1103,0,0,0,0,0,0,345,1103,1103,735,1345,1345
Justin Bean,2024-09-01,555,1345,1345,189,1103,1103,240,240,240,14,14,14,203,1117,1117,795,1585,1585
Justin Bean,2024-09-03,535,1325,1445,251,1285,1488,240,240,240,14,14,14,266,1300,1503,775,1565,1685
Justin Bean,2024-09-04,455,1310,1565,187,1245,1722,240,240,240,14,14,14,201,1259,1736,695,1550,1805
Justin Bean,2024-09-05,575,1295,1685,282,1243,1988,240,240,240,14,14,14,296,1258,2003,815,1535,1925
Justin Bean,2024-09-06,555,1300,1790,272,1274,2238,240,240,240,14,14,14,286,1288,2252,795,1540,2030
Justin Bean,2024-09-07,505,1240,1850,232,1153,2368,292,292,292,38,38,38,270,1191,2406,797,1532,2142
Justin Bean,2024-09-09,610,1165,1955,323,1014,2639,52,292,292,4,38,38,327,1052,2677,662,1457,2247
Justin Bean,2024-09-10,600,1135,2045,228,965,2883,52,292,292,4,38,38,232,1003,2921,652,1427,2337
Justin Bean,2024-09-11,480,935,2045,187,748,3047,52,292,292,4,38,38,191,786,3085,532,1227,2337
Justin Bean,2024-09-12,420,995,2105,143,826,3200,104,344,344,15,69,69,157,895,3268,524,1339,2449
Justin Bean,2024-09-13,365,920,2155,110,727,3340,176,416,416,37,112,112,146,839,3453,541,1336,2571
Justin Bean,2024-09-15,305,810,2155,82,591,3340,124,176,416,17,37,112,100,628,3453,429,986,2571
Justin Bean,2024-09-17,110,710,2035,15,369,3032,124,176,416,17,37,112,33,406,3144,234,886,2451
Justin Bean,2024-09-18,235,715,2025,31,372,2977,124,176,416,17,37,112,48,409,3089,359,891,2441
Justin Bean,2024-09-19,329,749,2044,102,487,3291,72,176,416,5,37,112,107,524,3403,401,925,2460
Justin Bean,2024-09-20,391,756,2056,137,491,3351,0,176,416,0,37,112,137,528,3464,391,932,2472
Justin Bean,2024-09-21,465,770,2010,195,531,3256,0,124,416,0,17,112,195,549,3369,465,894,2426
Justin Bean,2024-09-22,465,770,1830,195,531,2727,72,196,488,5,41,166,200,572,2893,537,966,2318
Justin Bean,2024-09-24,550,660,1795,264,409,2639,72,196,488,5,41,166,269,450,2805,622,856,2283
Justin Bean,2024-09-25,528,763,1698,248,458,2377,72,196,488,5,41,166,253,499,2543,600,959,2186
Justin Bean,2024-09-26,464,793,1788,158,515,2646,72,144,488,5,20,166,163,536,2812,536,937,2276
Justin Bean,2024-09-27,417,808,1728,138,549,2540,72,72,488,5,5,166,143,554,2706,489,880,2216
Justin Bean,2024-09-28,387,852,1662,128,639,2460,144,144,560,22,22,235,149,661,2695,531,996,2222
Justin Bean,2024-09-30,387,852,1662,128,639,2460,72,144,320,6,22,115,133,661,2575,459,996,1982
Justin Bean,2024-10-01,350,900,1610,116,729,2141,72,144,320,6,22,115,121,751,2257,422,1044,1930
Justin Bean,2024-10-02,323,851,1566,103,672,2051,72,144,320,6,22,115,109,694,2167,395,995,1886
Justin Bean,2024-10-03,284,748,1497,77,456,1886,72,144,320,6,22,115,82,478,2001,356,892,1817
Justin Bean,2024-10-04,219,636,1392,46,343,1656,144,216,392,22,48,169,68,391,1825,363,852,1784
Justin Bean,2024-10-05,259,646,1416,52,342,1728,72,216,340,5,48,122,57,390,1850,331,862,1756
Justin Bean,2024-10-06,259,646,1416,52,342,1728,160,232,428,24,53,188,76,396,1916,419,878,1844
Justin Bean,2024-10-08,294,644,1304,56,335,1487,160,232,428,24,53,188,80,388,1675,454,876,1732
Justin Bean,2024-10-09,314,637,1400,91,389,1694,160,232,428,24,53,188,115,442,1882,474,869,1828
Justin Bean,2024-10-10,344,628,1421,110,371,1762,160,232,376,24,53,139,134,424,1901,504,860,1797
Justin Bean,2024-10-11,389,608,1416,148,359,1798,152,296,368,23,89,136,171,448,1934,541,904,1784
Justin Bean,2024-10-12,356,615,1467,125,338,1907,152,224,368,23,49,136,147,388,2043,508,839,1835
Justin Bean,2024-10-13,356,615,1467,125,338,1907,156,316,460,23,95,207,148,433,2114,512,931,1927
Justin Bean,2024-10-14,396,655,1507,158,393,2034,156,316,460,23,95,207,182,488,2241,552,971,1967
Justin Bean,2024-10-15,355,649,1549,135,370,2138,244,404,548,54,149,285,189,519,2423,599,1053,2097
Justin Bean,2024-10-16,309,623,1474,80,343,1975,244,404,548,54,149,285,134,492,2260,553,1027,2022
Justin Bean,2024-10-17,275,619,1367,63,340,1586,312,472,616,90,208,363,154,548,1949,587,1091,1983
Justin Bean,2024-10-19,241,597,1243,46,322,1330,248,400,616,55,148,363,100,470,1693,489,997,1859
Justin Bean,2024-10-20,241,597,1243,46,322,1330,268,424,656,59,157,394,105,479,1724,509,1021,1899
Justin Bean,2024-10-22,258,613,1257,49,349,1370,180,424,656,27,157,394,76,506,1764,438,1037,1913
Justin Bean,2024-10-23,281,590,1227,67,295,1362,180,424,656,27,157,394,94,452,1756,461,1014,1883
Justin Bean,2024-10-24,285,560,1188,77,280,1295,352,664,896,53,292,600,130,572,1895,637,1224,2084
Khalifa Koumadje,2024-08-20,120,120,120,12,12,12,0,0,0,0,0,0,12,12,12,120,120,120
Khalifa Koumadje,2024-08-21,255,255,255,43,43,43,0,0,0,0,0,0,43,43,43,255,255,255
Khalifa Koumadje,2024-08-22,390,390,390,101,101,101,0,0,0,0,0,0,101,101,101,390,390,390
Khalifa Koumadje,2024-08-23,490,490,490,137,157,157,0,0,0,0,0,0,137,157,157,490,490,490
Khalifa Koumadje,2024-08-24,610,610,610,220,244,244,0,0,0,0,0,0,220,244,244,610,610,610
Khalifa Koumadje,2024-08-25,700,700,700,280,308,308,0,0,0,0,0,0,280,308,308,700,700,700
Khalifa Koumadje,2024-08-27,580,700,700,197,308,308,0,0,0,0,0,0,197,308,308,580,700,700
Khalifa Koumadje,2024-08-28,645,900,900,271,531,531,0,0,0,0,0,0,271,531,531,645,900,900
Khalifa Koumadje,2024-08-30,535,1025,1025,193,656,697,0,0,0,0,0,0,193,656,697,535,1025,1025
Khalifa Koumadje,2024-08-31,525,1135,1135,189,817,863,0,0,0,0,0,0,189,817,863,525,1135,1135
Khalifa Koumadje,2024-09-01,435,1135,1135,139,817,863,240,240,240,17,17,17,156,834,879,675,1375,1375
Khalifa Koumadje,2024-09-03,535,1115,1235,235,870,1087,240,240,240,17,17,17,252,887,1104,775,1355,1475
Khalifa Koumadje,2024-09-04,455,1100,1355,164,858,1287,240,240,240,17,17,17,181,875,1304,695,1340,1595
Khalifa Koumadje,2024-09-05,575,1085,1475,253,835,1519,240,240,240,17,17,17,270,852,1536,815,1325,1715
Khalifa Koumadje,2024-09-06,555,1090,1580,233,850,1738,240,240,240,17,17,17,250,867,1755,795,1330,1820
Khalifa Koumadje,2024-09-07,505,1030,1640,187,752,1853,308,308,308,43,43,43,230,795,1896,813,1338,1948
Khalifa Koumadje,2024-09-09,565,1000,1700,237,740,2006,68,308,308,5,43,43,242,783,2049,633,1308,2008
Khalifa Koumadje,2024-09-10,555,1090,1790,216,905,2273,68,308,308,5,43,43,221,948,2316,623,1398,2098
Khalifa Koumadje,2024-09-11,435,890,1790,170,668,2399,68,308,308,5,43,43,174,711,2442,503,1198,2098
Khalifa Koumadje,2024-09-12,375,950,1850,128,741,2535,152,392,392,21,82,82,149,823,2617,527,1342,2242
Khalifa Koumadje,2024-09-13,320,875,1900,96,630,2584,232,472,472,46,127,127,142,757,2711,552,1347,2372
Khalifa Koumadje,2024-09-15,260,765,1900,70,490,2584,232,300,540,51,87,194,121,577,2778,492,1065,2440
Khalifa Koumadje,2024-09-17,225,780,1895,43,452,2577,232,300,540,51,87,194,94,539,2772,457,1080,2435
Khalifa Koumadje,2024-09-18,370,805,1905,85,499,2667,232,300,540,51,87,194,136,586,2861,602,1105,2445
Khalifa Koumadje,2024-09-19,434,809,1894,135,526,2689,148,300,540,22,87,194,157,613,2884,582,1109,2434
Khalifa Koumadje,2024-09-20,496,816,1906,179,539,2745,68,300,540,6,87,194,185,626,2939,564,1116,2446
Khalifa Koumadje,2024-09-21,570,830,1860,239,573,2641,68,232,540,6,51,194,246,624,2836,638,1062,2400
Khalifa Koumadje,2024-09-22,570,830,1770,251,589,2478,68,300,608,5,87,261,256,676,2739,638,1130,2378
Khalifa Koumadje,2024-09-24,540,765,1855,243,490,2727,68,300,608,5,87,261,248,577,2988,608,1065,2463
Khalifa Koumadje,2024-09-25,498,868,1758,199,547,2426,68,300,608,5,87,261,204,634,2687,566,1168,2366
Khalifa Koumadje,2024-09-26,464,898,1848,167,602,2680,68,216,608,5,48,261,172,649,2941,532,1114,2456
Khalifa Koumadje,2024-09-27,417,913,1788,142,639,2539,68,136,608,5,22,261,147,661,2800,485,1049,2396
Khalifa Koumadje,2024-09-28,387,957,1722,132,727,2411,148,216,688,21,50,344,152,777,2755,535,1173,2410
Khalifa Koumadje,2024-09-30,502,1072,1837,191,879,2682,80,148,448,6,21,193,196,900,2875,582,1220,2285
Khalifa Koumadje,2024-10-01,515,1055,1835,206,897,2624,80,148,448,6,21,193,212,917,2817,595,1203,2283
Khalifa Koumadje,2024-10-02,508,1006,1811,229,855,2662,80,148,448,6,21,193,234,876,2855,588,1154,2259
Khalifa Koumadje,2024-10-03,469,933,1742,192,718,2474,80,148,448,6,21,193,198,739,2666,549,1081,2190
Khalifa Koumadje,2024-10-04,404,821,1637,141,566,2210,168,236,536,27,54,279,168,621,2489,572,1057,2173
Khalifa Koumadje,2024-10-05,459,846,1676,179,618,2380,88,236,468,8,54,211,187,672,2591,547,1082,2144
Khalifa Koumadje,2024-10-06,459,846,1676,179,601,2380,148,228,528,22,50,269,201,651,2649,607,1074,2204
Khalifa Koumadje,2024-10-08,329,844,1609,99,591,2156,148,228,528,22,50,269,121,641,2425,477,1072,2137
Khalifa Koumadje,2024-10-09,324,832,1700,100,632,2363,148,228,528,22,50,269,123,682,2632,472,1060,2228
Khalifa Koumadje,2024-10-10,354,823,1721,120,617,2444,148,228,444,22,50,195,143,667,2639,502,1051,2165
Khalifa Koumadje,2024-10-11,399,803,1716,160,602,2488,160,328,464,22,98,213,182,701,2702,559,1131,2180
Khalifa Koumadje,2024-10-12,351,810,1767,126,608,2668,160,248,464,22,57,213,149,665,2882,511,1058,2231
Khalifa Koumadje,2024-10-13,351,810,1767,126,608,2668,140,288,436,21,86,192,147,694,2860,491,1098,2203
Khalifa Koumadje,2024-10-14,391,735,1807,156,537,2801,140,288,436,21,86,192,177,623,2993,531,1023,2243
Khalifa Koumadje,2024-10-15,350,679,1734,130,455,2636,200,348,496,42,125,248,172,580,2884,550,1027,2230
Khalifa Koumadje,2024-10-16,309,633,1639,87,373,2360,200,348,496,42,125,248,129,499,2608,509,981,2135
Khalifa Koumadje,2024-10-17,275,629,1562,69,371,2124,268,416,564,78,183,327,146,554,2451,543,1045,2126
Khalifa Koumadje,2024-10-19,241,592,1438,46,326,1841,168,328,564,35,115,327,81,440,2168,409,920,2002
Khalifa Koumadje,2024-10-20,241,592,1438,46,326,1812,188,328,556,38,115,317,83,440,2129,429,920,1994
Khalifa Koumadje,2024-10-22,268,618,1462,64,377,1915,128,328,556,18,115,317,82,492,2232,396,946,2018
Khalifa Koumadje,2024-10-23,301,610,1442,93,360,1947,128,328,556,18,115,317,111,475,2264,429,938,1998
Khalifa Koumadje,2024-10-24,305,580,1403,104,342,1880,300,568,796,36,233,501,140,575,2382,605,1148,2199
Louis Olinde,2024-08-20,120,120,120,8,24,40,0,0,0,0,0,0,8,24,40,120,120,120
Louis Olinde,2024-08-21,255,255,255,36,69,102,0,0,0,0,0,0,36,69,102,255,255,255
Louis Olinde,2024-08-22,390,390,390,82,133,183,0,0,0,0,0,0,82,133,183,390,390,390
Louis Olinde,2024-08-23,490,490,490,132,196,260,0,0,0,0,0,0,132,196,260,490,490,490
Louis Olinde,2024-08-24,610,610,610,207,287,366,0,0,0,0,0,0,207,287,366,610,610,610
Louis Olinde,2024-08-25,790,790,790,340,395,545,0,0,0,0,0,0,340,395,545,790,790,790
Louis Olinde,2024-08-27,790,910,910,356,473,710,0,0,0,0,0,0,356,473,710,790,910,910
Louis Olinde,2024-08-28,855,1110,1110,419,699,988,0,0,0,0,0,0,419,699,988,855,1110,1110
Louis Olinde,2024-08-30,745,1235,1235,335,889,1210,0,0,0,0,0,0,335,889,1210,745,1235,1235
Louis Olinde,2024-08-31,735,1345,1345,331,1063,1412,0,0,0,0,0,0,331,1063,1412,735,1345,1345
Louis Olinde,2024-09-01,555,1345,1345,200,1063,1372,240,240,240,19,19,19,219,1082,1391,795,1585,1585
Louis Olinde,2024-09-03,535,1325,1445,209,1113,1503,240,240,240,19,19,19,228,1132,1522,775,1565,1685
Louis Olinde,2024-09-04,455,1310,1565,164,1114,1753,240,240,240,19,19,19,183,1133,1772,695,1550,1805
Louis Olinde,2024-09-05,575,1295,1685,253,1114,2022,240,240,240,19,19,19,272,1133,2041,815,1535,1925
Louis Olinde,2024-09-06,555,1300,1790,233,1131,2273,240,240,240,19,19,19,252,1150,2293,795,1540,2030
Louis Olinde,2024-09-07,505,1240,1850,192,1029,2405,320,320,320,54,54,54,246,1084,2459,825,1560,2170
Louis Olinde,2024-09-09,610,1165,1955,281,955,2444,80,320,320,7,54,54,288,1010,2498,690,1485,2275
Louis Olinde,2024-09-10,600,1135,2045,240,897,2679,80,320,320,7,54,54,247,951,2733,680,1455,2365
Louis Olinde,2024-09-11,480,935,2045,187,701,2822,80,320,320,7,54,54,194,756,2877,560,1255,2365
Louis Olinde,2024-09-12,420,995,2105,143,776,2968,160,400,400,24,92,92,167,868,3060,580,1395,2505
Louis Olinde,2024-09-13,365,920,2155,110,662,3103,248,488,488,57,151,151,167,814,3254,613,1408,2643
Louis Olinde,2024-09-15,305,810,2155,82,527,3103,240,320,560,55,102,224,138,629,3327,545,1130,2715
Louis Olinde,2024-09-17,225,825,2150,41,479,3053,240,320,560,55,102,224,96,581,3277,465,1145,2710
Louis Olinde,2024-09-18,350,830,2140,67,481,3060,240,320,560,55,102,224,122,584,3284,590,1150,2700
Louis Olinde,2024-09-19,414,834,2129,120,525,3172,160,320,560,27,102,224,147,628,3396,574,1154,2689
Louis Olinde,2024-09-20,476,841,2141,157,530,3212,72,320,560,6,102,224,164,632,3436,548,1161,2701
Louis Olinde,2024-09-21,550,855,2095,209,556,3101,72,240,560,6,55,224,215,611,3325,622,1095,2655
Louis Olinde,2024-09-22,550,855,1915,220,573,2700,100,340,660,9,109,323,229,682,3024,650,1195,2575
Louis Olinde,2024-09-24,435,660,1795,152,350,2369,100,340,660,9,109,323,161,459,2693,535,1000,2455
Louis Olinde,2024-09-25,310,660,1595,84,304,1930,100,340,660,9,109,323,93,412,2253,410,1000,2255
Louis Olinde,2024-09-26,276,690,1685,63,359,2191,100,260,660,9,68,323,72,426,2514,376,950,2345
Louis Olinde,2024-09-27,229,705,1625,53,395,2080,100,172,660,9,31,323,62,426,2403,329,877,2285
Louis Olinde,2024-09-28,199,749,1559,48,464,1980,184,256,744,33,69,432,81,534,2411,383,1005,2303
Louis Olinde,2024-09-30,314,864,1674,82,570,2193,84,184,504,8,33,252,89,603,2445,398,1048,2178
Louis Olinde,2024-10-01,412,847,1672,132,567,2090,84,184,504,8,33,252,139,601,2342,496,1031,2176
Louis Olinde,2024-10-02,488,798,1628,176,503,1970,84,184,504,8,33,252,183,536,2222,572,982,2132
Louis Olinde,2024-10-03,449,725,1559,135,384,1808,84,184,504,8,33,252,142,417,2060,533,909,2063
Louis Olinde,2024-10-04,384,613,1454,88,282,1585,184,284,604,31,74,350,120,356,1935,568,897,2058
Louis Olinde,2024-10-05,424,623,1478,89,280,1626,100,284,524,8,74,257,97,354,1883,524,907,2002
Louis Olinde,2024-10-06,424,623,1478,89,268,1626,180,264,604,29,66,344,118,334,1970,604,887,2082
Louis Olinde,2024-10-08,294,706,1366,44,332,1366,180,264,604,29,66,344,73,398,1710,474,970,1970
Louis Olinde,2024-10-09,319,807,1467,70,468,1526,180,264,604,29,66,344,99,534,1870,499,1071,2071
Louis Olinde,2024-10-10,349,798,1488,84,431,1577,180,264,524,29,66,267,113,497,1845,529,1062,2012
Louis Olinde,2024-10-11,394,778,1483,118,412,1616,176,360,532,28,119,271,146,531,1888,570,1138,2015
Louis Olinde,2024-10-12,361,785,1534,116,416,1764,176,276,532,28,66,271,144,482,2035,537,1061,2066
Louis Olinde,2024-10-13,361,785,1534,116,416,1764,192,372,556,33,123,284,148,539,2048,553,1157,2090
Louis Olinde,2024-10-14,416,725,1589,162,406,1939,192,372,556,33,123,284,195,529,2222,608,1097,2145
Louis Olinde,2024-10-15,375,669,1516,143,355,1819,300,480,664,75,197,392,218,551,2211,675,1149,2180
Louis Olinde,2024-10-16,334,653,1451,117,372,1741,300,480,664,75,197,392,192,569,2133,634,1133,2115
Louis Olinde,2024-10-17,300,649,1374,99,370,1511,404,584,768,133,286,515,232,656,2026,704,1233,2142
Louis Olinde,2024-10-19,266,627,1250,69,364,1288,308,484,768,77,198,515,146,562,1802,574,1111,2018
Louis Olinde,2024-10-20,266,627,1250,69,364,1263,316,508,772,82,218,525,151,582,1787,582,1135,2022
Louis Olinde,2024-10-22,221,596,1302,49,358,1393,208,508,772,37,218,525,86,576,1918,429,1104,2074
Louis Olinde,2024-10-23,234,568,1375,44,307,1540,208,508,772,37,218,525,82,525,2065,442,1076,2147
Louis Olinde,2024-10-24,238,538,1336,52,296,1456,344,748,1012,62,381,769,114,677,2225,582,1286,2348
Malte Delow,2024-08-20,120,120,120,6,28,35,0,0,0,0,0,0,6,28,35,120,120,120
Malte Delow,2024-08-21,255,255,255,31,77,92,0,0,0,0,0,0,31,77,92,255,255,255
Malte Delow,2024-08-22,390,390,390,74,144,168,0,0,0,0,0,0,74,144,168,390,390,390
Malte Delow,2024-08-23,490,490,490,127,216,245,0,0,0,0,0,0,127,216,245,490,490,490
Malte Delow,2024-08-24,610,610,610,207,317,354,0,0,0,0,0,0,207,317,354,610,610,610
Malte Delow,2024-08-25,700,700,700,266,357,434,0,0,0,0,0,0,266,357,434,700,700,700
Malte Delow,2024-08-27,700,820,820,280,369,566,0,0,0,0,0,0,280,369,566,700,820,820
Malte Delow,2024-08-28,765,1020,1020,329,561,806,0,0,0,0,0,0,329,561,806,765,1020,1020
Malte Delow,2024-08-30,655,1145,1145,229,698,905,0,0,0,0,0,0,229,698,905,655,1145,1145
Malte Delow,2024-08-31,645,1255,1255,213,841,1067,0,0,0,0,0,0,213,841,1067,645,1255,1255
Malte Delow,2024-09-01,555,1255,1255,161,841,1067,240,240,240,17,17,17,178,858,1084,795,1495,1495
Malte Delow,2024-09-03,535,1235,1355,182,914,1314,240,240,240,17,17,17,199,931,1331,775,1475,1595
Malte Delow,2024-09-04,455,1220,1475,141,903,1534,240,240,240,17,17,17,158,920,1551,695,1460,1715
Malte Delow,2024-09-05,575,1205,1595,207,868,1739,240,240,240,17,17,17,224,884,1755,815,1445,1835
Malte Delow,2024-09-06,555,1210,1700,200,859,1955,240,240,240,17,17,17,217,876,1972,795,1450,1940
Malte Delow,2024-09-07,505,1150,1760,167,759,2077,320,320,320,38,38,38,205,797,2115,825,1470,2080
Malte Delow,2024-09-09,610,1165,1865,238,792,2089,80,320,320,4,38,38,242,831,2127,690,1485,2185
Malte Delow,2024-09-10,600,1135,1955,192,749,2170,80,320,320,4,38,38,196,788,2208,680,1455,2275
Malte Delow,2024-09-11,480,935,1955,144,570,2268,80,320,320,4,38,38,148,609,2306,560,1255,2275
Malte Delow,2024-09-12,420,995,2015,118,637,2398,180,420,420,22,80,80,139,717,2478,600,1415,2435
Malte Delow,2024-09-13,365,920,2065,91,561,2519,260,500,500,52,135,135,143,696,2654,625,1420,2565
Malte Delow,2024-09-15,305,810,2065,67,446,2519,240,320,560,50,83,185,118,529,2704,545,1130,2625
Malte Delow,2024-09-17,140,740,1975,24,363,2429,240,320,560,50,83,185,74,446,2614,380,1060,2535
Malte Delow,2024-09-18,140,620,1840,17,260,2134,240,320,560,50,83,185,67,344,2319,380,940,2400
Malte Delow,2024-09-19,80,500,1705,7,185,1858,140,320,560,20,83,185,27,268,2043,220,820,2265
Malte Delow,2024-09-20,30,395,1605,2,122,1637,60,320,560,4,83,185,5,206,1822,90,715,2165
Malte Delow,2024-09-21,30,335,1485,2,94,1396,60,240,560,4,50,185,5,144,1581,90,575,2045
Malte Delow,2024-09-22,30,335,1395,2,94,1256,0,240,560,0,50,185,2,144,1440,30,575,1955
Malte Delow,2024-09-24,0,140,1275,0,24,1058,0,240,560,0,50,185,0,74,1243,0,380,1835
Malte Delow,2024-09-25,0,140,1075,0,17,785,0,240,560,0,50,185,0,67,970,0,380,1635
Malte Delow,2024-09-26,0,80,1075,0,7,785,0,140,560,0,20,185,0,27,970,0,220,1635
Malte Delow,2024-09-27,0,30,950,0,2,637,0,60,560,0,4,185,0,5,821,0,90,1510
Malte Delow,2024-09-28,44,74,884,3,9,592,0,60,560,0,4,185,3,12,777,44,134,1444
Malte Delow,2024-09-30,44,74,884,3,9,592,0,0,320,0,0,83,3,9,675,44,74,1204
Malte Delow,2024-10-01,44,44,784,3,3,431,0,0,320,0,0,83,3,3,514,44,44,1104
Malte Delow,2024-10-02,44,44,664,3,3,319,0,0,320,0,0,83,3,3,402,44,44,984
Malte Delow,2024-10-03,44,44,544,3,3,234,0,0,320,0,0,83,3,3,317,44,44,864
Malte Delow,2024-10-04,44,44,439,3,3,162,0,0,320,0,0,83,3,3,246,44,44,759
Malte Delow,2024-10-05,0,44,379,0,3,129,0,0,240,0,0,50,0,3,179,0,44,619
Malte Delow,2024-10-06,0,44,379,0,3,129,0,0,240,0,0,50,0,3,179,0,44,619
Malte Delow,2024-10-08,0,44,184,0,3,42,0,0,240,0,0,50,0,3,93,0,44,424
Malte Delow,2024-10-09,0,44,184,0,3,33,0,0,240,0,0,50,0,3,84,0,44,424
Malte Delow,2024-10-10,0,44,124,0,3,19,0,0,140,0,0,20,0,3,38,0,44,264
Malte Delow,2024-10-11,0,44,74,0,3,9,0,0,60,0,0,4,0,3,12,0,44,134
Malte Delow,2024-10-12,0,0,74,0,0,9,0,0,60,0,0,4,0,0,12,0,0,134
Malte Delow,2024-10-13,0,0,74,0,0,9,0,0,0,0,0,0,0,0,9,0,0,74
Malte Delow,2024-10-14,0,0,74,0,0,9,0,0,0,0,0,0,0,0,9,0,0,74
Malte Delow,2024-10-15,0,0,44,0,0,3,0,0,0,0,0,0,0,0,3,0,0,44
Malte Delow,2024-10-16,0,0,44,0,0,3,0,0,0,0,0,0,0,0,3,0,0,44
Malte Delow,2024-10-17,0,0,44,0,0,3,0,0,0,0,0,0,0,0,3,0,0,44
Malte Delow,2024-10-19,0,0,44,0,0,3,0,0,0,0,0,0,0,0,3,0,0,44
Malte Delow,2024-10-20,0,0,44,0,0,3,0,0,0,0,0,0,0,0,3,0,0,44
Malte Delow,2024-10-22,0,0,44,0,0,3,0,0,0,0,0,0,0,0,3,0,0,44
Malte Delow,2024-10-23,0,0,44,0,0,3,0,0,0,0,0,0,0,0,3,0,0,44
Malte Delow,2024-10-24,0,0,44,0,0,3,0,0,0,0,0,0,0,0,3,0,0,44
Martin Hermannsson,2024-08-20,120,120,120,8,8,8,0,0,0,0,0,0,8,8,8,120,120,120
Martin Hermannsson,2024-08-21,255,255,255,38,38,38,0,0,0,0,0,0,38,38,38,255,255,255
Martin Hermannsson,2024-08-22,390,390,390,90,90,90,0,0,0,0,0,0,90,90,90,390,390,390
Martin Hermannsson,2024-08-23,490,490,490,152,152,152,0,0,0,0,0,0,152,152,152,490,490,490
Martin Hermannsson,2024-08-24,610,610,610,238,238,238,0,0,0,0,0,0,238,238,238,610,610,610
Martin Hermannsson,2024-08-25,790,790,790,435,435,435,0,0,0,0,0,0,435,435,435,790,790,790
Martin Hermannsson,2024-08-27,790,910,910,450,582,582,0,0,0,0,0,0,450,582,582,790,910,910
Martin Hermannsson,2024-08-28,855,1110,1110,547,877,877,0,0,0,0,0,0,547,877,877,855,1110,1110
Martin Hermannsson,2024-08-30,745,1235,1235,432,1099,1099,0,0,0,0,0,0,432,1099,1099,745,1235,1235
Martin Hermannsson,2024-08-31,735,1345,1345,419,1291,1291,0,0,0,0,0,0,419,1291,1291,735,1345,1345
Martin Hermannsson,2024-09-01,555,1345,1345,228,1291,1291,0,0,0,0,0,0,228,1291,1291,555,1345,1345
Martin Hermannsson,2024-09-03,535,1325,1445,241,1352,1575,0,0,0,0,0,0,241,1352,1575,535,1325,1445
Martin Hermannsson,2024-09-04,335,1190,1445,101,1119,1575,0,0,0,0,0,0,101,1119,1575,335,1190,1445
Martin Hermannsson,2024-09-05,440,1160,1550,167,1090,1814,0,0,0,0,0,0,167,1090,1814,440,1160,1550
Martin Hermannsson,2024-09-06,420,1165,1655,155,1107,2085,0,0,0,0,0,0,155,1107,2085,420,1165,1655
Martin Hermannsson,2024-09-07,370,1105,1715,122,995,2212,64,64,64,6,6,6,128,1000,2218,434,1169,1779
Martin Hermannsson,2024-09-09,475,1030,1820,200,855,2512,64,64,64,6,6,6,205,861,2517,539,1094,1884
Martin Hermannsson,2024-09-10,375,910,1820,109,673,2512,64,64,64,6,6,6,115,679,2517,439,974,1884
Martin Hermannsson,2024-09-11,375,710,1820,135,469,2639,64,64,64,6,6,6,141,474,2645,439,774,1884
Martin Hermannsson,2024-09-12,330,770,1880,102,531,2782,100,100,100,15,15,15,117,546,2797,430,870,1980
Martin Hermannsson,2024-09-13,275,695,1930,69,431,2914,188,188,188,45,45,45,114,476,2959,463,883,2118
Martin Hermannsson,2024-09-15,215,585,1930,47,322,2914,216,280,280,52,92,92,99,414,3007,431,865,2210
Martin Hermannsson,2024-09-17,225,600,1925,47,300,2926,216,280,280,52,92,92,99,392,3018,441,880,2205
Martin Hermannsson,2024-09-18,370,745,1935,111,492,3096,216,280,280,52,92,92,163,584,3188,586,1025,2215
Martin Hermannsson,2024-09-19,444,774,1934,186,565,3230,180,280,280,32,92,92,219,657,3322,624,1054,2214
Martin Hermannsson,2024-09-20,506,781,1946,243,570,3269,92,280,280,8,92,92,251,663,3362,598,1061,2226
Martin Hermannsson,2024-09-21,580,795,1900,325,620,3192,92,216,280,8,52,92,333,672,3284,672,1011,2180
Martin Hermannsson,2024-09-22,580,795,1720,325,620,2614,96,312,376,9,103,158,333,723,2772,676,1107,2096
Martin Hermannsson,2024-09-24,550,775,1685,314,605,2561,96,312,376,9,103,158,322,707,2719,646,1087,2061
Martin Hermannsson,2024-09-25,508,878,1588,254,702,2318,96,312,376,9,103,158,263,805,2476,604,1190,1964
Martin Hermannsson,2024-09-26,443,887,1657,186,745,2535,96,276,376,9,75,158,195,820,2693,539,1163,2033
Martin Hermannsson,2024-09-27,396,902,1597,154,785,2380,96,188,376,9,34,158,163,819,2537,492,1090,1973
Martin Hermannsson,2024-09-28,366,946,1531,139,889,2281,192,284,472,35,77,241,174,966,2522,558,1230,2003
Martin Hermannsson,2024-09-30,474,1054,1639,209,1054,2540,96,192,472,9,35,241,217,1089,2781,570,1246,2111
Martin Hermannsson,2024-10-01,487,1037,1637,209,1037,2456,96,192,472,9,35,241,218,1072,2696,583,1229,2109
Martin Hermannsson,2024-10-02,460,968,1713,179,862,2655,96,192,472,9,35,241,188,896,2896,556,1160,2185
Martin Hermannsson,2024-10-03,442,885,1659,155,681,2489,96,192,472,9,35,241,163,716,2729,538,1077,2131
Martin Hermannsson,2024-10-04,377,773,1554,109,526,2191,204,300,580,35,78,342,144,604,2533,581,1073,2134
Martin Hermannsson,2024-10-05,417,783,1578,117,517,2272,108,300,516,9,78,258,125,595,2530,525,1083,2094
Martin Hermannsson,2024-10-06,417,783,1578,117,517,2272,212,308,620,36,80,366,153,597,2638,629,1091,2198
Martin Hermannsson,2024-10-08,294,781,1556,56,484,2178,212,308,620,36,80,366,92,564,2544,506,1089,2176
Martin Hermannsson,2024-10-09,299,759,1637,66,463,2308,212,308,620,36,80,366,102,543,2674,511,1067,2257
Martin Hermannsson,2024-10-10,329,771,1658,79,455,2371,212,308,584,36,80,310,115,535,2680,541,1079,2242
Martin Hermannsson,2024-10-11,374,751,1653,116,451,2430,212,416,604,38,146,320,154,596,2750,586,1167,2257
Martin Hermannsson,2024-10-12,341,758,1704,109,455,2624,212,320,604,38,83,320,147,538,2944,553,1078,2308
Martin Hermannsson,2024-10-13,341,758,1704,109,455,2624,212,424,616,38,148,326,147,603,2951,553,1182,2320
Martin Hermannsson,2024-10-14,381,690,1744,133,393,2738,212,424,616,38,148,326,172,542,3065,593,1114,2360
Martin Hermannsson,2024-10-15,340,634,1671,112,330,2540,316,528,720,82,227,439,194,557,2979,656,1162,2391
Martin Hermannsson,2024-10-16,309,608,1576,87,304,2191,316,528,720,82,227,439,169,531,2630,625,1136,2296
Martin Hermannsson,2024-10-17,275,604,1489,72,302,1891,420,632,824,143,322,569,214,624,2460,695,1236,2313
Martin Hermannsson,2024-10-19,241,582,1365,41,285,1570,312,524,824,78,225,569,119,511,2138,553,1106,2189
Martin Hermannsson,2024-10-20,241,582,1365,41,285,1570,312,524,832,75,220,566,116,505,2136,553,1106,2197
Martin Hermannsson,2024-10-22,258,598,1379,49,311,1572,208,524,832,33,220,566,82,531,2138,466,1122,2211
Martin Hermannsson,2024-10-23,281,590,1349,65,301,1511,208,524,832,33,220,566,98,521,2077,489,1114,2181
Martin Hermannsson,2024-10-24,285,560,1331,77,297,1491,344,764,1072,55,382,815,132,679,2305,629,1324,2403
Matt Thomas,2024-08-20,120,120,120,7,7,7,0,0,0,0,0,0,7,7,7,120,120,120
Matt Thomas,2024-08-21,255,255,255,31,31,31,0,0,0,0,0,0,31,31,31,255,255,255
Matt Thomas,2024-08-22,390,390,390,74,74,74,0,0,0,0,0,0,74,74,74,390,390,390
Matt Thomas,2024-08-23,480,480,480,120,120,120,0,0,0,0,0,0,120,120,120,480,480,480
Matt Thomas,2024-08-24,540,540,540,178,178,178,0,0,0,0,0,0,178,178,178,540,540,540
Matt Thomas,2024-08-25,660,660,660,290,290,290,0,0,0,0,0,0,290,290,290,660,660,660
Matt Thomas,2024-08-27,600,720,720,270,367,367,0,0,0,0,0,0,270,367,367,600,720,720
Matt Thomas,2024-08-28,555,810,810,261,478,478,0,0,0,0,0,0,261,478,478,555,810,810
Matt Thomas,2024-08-30,455,935,935,187,617,617,0,0,0,0,0,0,187,617,617,455,935,935
Matt Thomas,2024-08-31,505,1045,1045,202,763,763,0,0,0,0,0,0,202,763,763,505,1045,1045
Matt Thomas,2024-09-01,385,1045,1045,112,763,763,0,0,0,0,0,0,112,763,763,385,1045,1045
Matt Thomas,2024-09-03,425,1025,1145,123,759,916,0,0,0,0,0,0,123,759,916,425,1025,1145
Matt Thomas,2024-09-04,455,1010,1265,137,778,1126,0,0,0,0,0,0,137,778,1126,455,1010,1265
Matt Thomas,2024-09-05,560,980,1370,207,755,1315,0,0,0,0,0,0,207,755,1315,560,980,1370
Matt Thomas,2024-09-06,540,995,1475,200,776,1519,0,0,0,0,0,0,200,776,1519,540,995,1475
Matt Thomas,2024-09-07,490,995,1535,162,726,1627,52,52,52,3,3,3,165,729,1630,542,1047,1587
Matt Thomas,2024-09-09,595,980,1640,244,686,1870,52,52,52,3,3,3,247,689,1873,647,1032,1692
Matt Thomas,2024-09-10,495,920,1640,168,580,1870,52,52,52,3,3,3,171,583,1873,547,972,1692
Matt Thomas,2024-09-11,375,830,1640,94,457,1870,52,52,52,3,3,3,97,460,1873,427,882,1692
Matt Thomas,2024-09-12,270,830,1640,62,498,1952,52,52,52,3,3,3,65,501,1955,322,882,1692
Matt Thomas,2024-09-13,215,755,1690,41,423,2062,52,52,52,3,3,3,44,426,2065,267,807,1742
Matt Thomas,2024-09-14,215,705,1750,45,381,2223,0,52,52,0,3,3,45,384,2226,215,757,1802
Matt Thomas,2024-09-15,275,765,1810,72,451,2389,0,52,52,0,3,3,72,454,2392,275,817,1862
Matt Thomas,2024-09-17,170,665,1690,31,346,2129,0,52,52,0,3,3,31,349,2133,170,717,1742
Matt Thomas,2024-09-18,170,545,1555,31,234,1866,0,52,52,0,3,3,31,237,1869,170,597,1607
Matt Thomas,2024-09-19,195,465,1445,35,191,1705,0,52,52,0,3,3,35,194,1708,195,517,1497
Matt Thomas,2024-09-20,145,360,1355,22,122,1518,0,52,52,0,3,3,22,126,1521,145,412,1407
Matt Thomas,2024-09-21,85,300,1295,9,93,1347,0,0,52,0,0,3,9,93,1350,85,300,1347
Matt Thomas,2024-09-22,25,300,1175,1,93,1093,0,0,52,0,0,3,1,93,1096,25,300,1227
Matt Thomas,2024-09-24,45,215,1135,5,65,1056,0,0,52,0,0,3,5,65,1059,45,215,1187
Matt Thomas,2024-09-25,148,318,1148,30,121,1068,0,0,52,0,0,3,30,121,1071,148,318,1200
Matt Thomas,2024-09-26,213,408,1238,51,171,1263,0,0,52,0,0,3,51,171,1266,213,408,1290
Matt Thomas,2024-09-27,278,423,1178,86,195,1202,0,0,52,0,0,3,86,195,1205,278,423,1230
Matt Thomas,2024-09-28,278,363,1068,86,149,1015,0,0,52,0,0,3,86,149,1018,278,363,1120
Matt Thomas,2024-09-30,278,303,1068,86,109,1015,0,0,52,0,0,3,86,109,1018,278,303,1120
Matt Thomas,2024-10-01,288,333,998,84,137,928,0,0,52,0,0,3,84,137,931,288,333,1050
Matt Thomas,2024-10-02,185,333,878,39,137,738,0,0,52,0,0,3,39,137,741,185,333,930
Matt Thomas,2024-10-03,95,308,773,11,111,595,0,0,52,0,0,3,11,111,598,95,308,825
Matt Thomas,2024-10-04,30,308,668,2,111,468,0,0,52,0,0,3,2,111,471,30,308,720
Matt Thomas,2024-10-05,60,338,638,6,139,459,0,0,0,0,0,0,6,139,459,60,338,638
Matt Thomas,2024-10-06,60,338,638,6,139,459,0,0,0,0,0,0,6,139,459,60,338,638
Matt Thomas,2024-10-08,30,318,533,2,108,341,0,0,0,0,0,0,2,108,341,30,318,533
Matt Thomas,2024-10-09,30,215,533,2,56,341,0,0,0,0,0,0,2,56,341,30,215,533
Matt Thomas,2024-10-10,30,125,533,2,21,314,0,0,0,0,0,0,2,21,314,30,125,533
Matt Thomas,2024-10-11,30,60,483,2,6,270,0,0,0,0,0,0,2,6,270,30,60,483
Matt Thomas,2024-10-12,0,60,423,0,6,216,0,0,0,0,0,0,0,6,216,0,60,423
Matt Thomas,2024-10-13,0,60,363,0,6,167,0,0,0,0,0,0,0,6,167,0,60,363
Matt Thomas,2024-10-14,0,60,363,0,6,167,0,0,0,0,0,0,0,6,167,0,60,363
Matt Thomas,2024-10-15,0,30,363,0,2,167,0,0,0,0,0,0,0,2,167,0,30,363
Matt Thomas,2024-10-16,0,30,363,0,2,167,0,0,0,0,0,0,0,2,167,0,30,363
Matt Thomas,2024-10-17,0,30,338,0,2,139,0,0,0,0,0,0,0,2,139,0,30,338
Matt Thomas,2024-10-19,0,0,338,0,0,139,0,0,0,0,0,0,0,0,139,0,0,338
Matt Thomas,2024-10-20,0,0,338,0,0,139,0,0,0,0,0,0,0,0,139,0,0,338
Matt Thomas,2024-10-22,0,0,318,0,0,108,0,0,0,0,0,0,0,0,108,0,0,318
Matt Thomas,2024-10-23,35,35,250,2,2,78,0,0,0,0,0,0,2,2,78,35,35,250
Matt Thomas,2024-10-24,35,35,160,2,2,35,0,0,0,0,0,0,2,2,35,35,35,160
Matteo Spagnolo,2024-08-20,120,120,120,14,14,14,0,0,0,0,0,0,14,14,14,120,120,120
Matteo Spagnolo,2024-08-21,255,255,255,51,51,51,0,0,0,0,0,0,51,51,51,255,255,255
Matteo Spagnolo,2024-08-22,390,390,390,109,109,109,0,0,0,0,0,0,109,109,109,390,390,390
Matteo Spagnolo,2024-08-23,490,490,490,152,176,176,0,0,0,0,0,0,152,176,176,490,490,490
Matteo Spagnolo,2024-08-24,610,610,610,244,275,275,0,0,0,0,0,0,244,275,275,610,610,610
Matteo Spagnolo,2024-08-25,700,700,700,329,364,364,0,0,0,0,0,0,329,364,364,700,700,700
Matteo Spagnolo,2024-08-27,580,700,700,232,364,364,0,0,0,0,0,0,232,364,364,580,700,700
Matteo Spagnolo,2024-08-28,445,700,700,142,364,364,0,0,0,0,0,0,142,364,364,445,700,700
Matteo Spagnolo,2024-08-30,335,825,825,80,454,495,0,0,0,0,0,0,80,454,495,335,825,825
Matteo Spagnolo,2024-08-31,325,935,935,68,570,617,0,0,0,0,0,0,68,570,617,325,935,935
Matteo Spagnolo,2024-09-01,235,935,935,33,570,617,88,88,88,8,8,8,41,578,625,323,1023,1023
Matteo Spagnolo,2024-09-03,335,915,1035,97,631,838,88,88,88,8,8,8,105,639,846,423,1003,1123
Matteo Spagnolo,2024-09-04,335,780,1035,97,476,838,88,88,88,8,8,8,105,484,846,423,868,1123
Matteo Spagnolo,2024-09-05,455,765,1155,164,459,1016,88,88,88,8,8,8,172,467,1024,543,853,1243
Matteo Spagnolo,2024-09-06,435,770,1260,152,454,1197,88,88,88,8,8,8,160,462,1205,523,858,1348
Matteo Spagnolo,2024-09-07,385,710,1320,123,376,1294,152,152,152,24,24,24,148,401,1318,537,862,1472
Matteo Spagnolo,2024-09-09,490,725,1425,191,384,1496,64,152,152,4,24,24,196,409,1521,554,877,1577
Matteo Spagnolo,2024-09-10,480,815,1515,149,489,1697,64,152,152,4,24,24,153,513,1721,544,967,1667
Matteo Spagnolo,2024-09-11,480,815,1515,182,546,1803,64,152,152,4,24,24,187,570,1827,544,967,1667
Matteo Spagnolo,2024-09-12,420,875,1575,143,613,1922,108,196,196,15,45,45,158,658,1967,528,1071,1771
Matteo Spagnolo,2024-09-13,365,800,1625,110,520,1950,108,196,196,15,45,45,125,565,1995,473,996,1821
Matteo Spagnolo,2024-09-15,305,690,1625,82,407,1950,136,200,288,20,44,89,103,451,2039,441,890,1913
Matteo Spagnolo,2024-09-17,225,705,1620,45,360,1944,136,200,288,20,44,89,65,404,2033,361,905,1908
Matteo Spagnolo,2024-09-18,350,830,1610,74,490,1932,136,200,288,20,44,89,94,534,2021,486,1030,1898
Matteo Spagnolo,2024-09-19,414,834,1599,124,534,1983,92,200,288,7,44,89,132,578,2072,506,1034,1887
Matteo Spagnolo,2024-09-20,476,841,1611,167,547,1998,92,200,288,7,44,89,174,591,2087,568,1041,1899
Matteo Spagnolo,2024-09-21,550,855,1565,226,581,1894,92,136,288,7,20,89,233,602,1983,642,991,1853
Matteo Spagnolo,2024-09-22,550,855,1475,237,599,1711,92,228,380,7,52,148,244,651,1859,642,1083,1855
Matteo Spagnolo,2024-09-24,520,745,1560,224,469,1919,92,228,380,7,52,148,231,522,2067,612,973,1940
Matteo Spagnolo,2024-09-25,428,778,1593,175,482,2055,92,228,380,7,52,148,183,535,2203,520,1006,1973
Matteo Spagnolo,2024-09-26,304,718,1593,88,424,2055,92,184,380,7,29,148,96,453,2203,396,902,1973
Matteo Spagnolo,2024-09-27,257,733,1533,72,462,1962,92,184,380,7,29,148,79,491,2110,349,917,1913
Matteo Spagnolo,2024-09-28,227,777,1467,66,544,1892,168,260,456,27,62,214,93,606,2107,395,1037,1923
Matteo Spagnolo,2024-09-30,342,892,1582,109,669,2120,76,168,368,6,27,140,116,696,2260,418,1060,1950
Matteo Spagnolo,2024-10-01,355,875,1580,117,665,2007,76,168,368,6,27,140,123,692,2146,431,1043,1948
Matteo Spagnolo,2024-10-02,408,836,1666,155,660,2299,76,168,368,6,27,140,161,687,2439,484,1004,2034
Matteo Spagnolo,2024-10-03,459,763,1597,188,534,2140,76,168,368,6,27,140,194,561,2280,535,931,1965
Matteo Spagnolo,2024-10-04,394,651,1492,134,404,1895,76,168,368,8,32,151,142,436,2046,470,819,1860
Matteo Spagnolo,2024-10-05,434,661,1516,143,410,1971,0,168,304,0,32,103,143,442,2074,434,829,1820
Matteo Spagnolo,2024-10-06,434,661,1516,143,397,1971,80,156,384,9,30,161,152,426,2132,514,817,1900
Matteo Spagnolo,2024-10-08,304,659,1404,82,395,1727,80,156,384,9,30,161,91,425,1888,384,815,1788
Matteo Spagnolo,2024-10-09,314,722,1500,88,477,1920,80,156,384,9,30,161,97,506,2081,394,878,1884
Matteo Spagnolo,2024-10-10,344,803,1521,107,578,1993,80,156,340,9,30,119,115,608,2112,424,959,1861
Matteo Spagnolo,2024-10-11,389,783,1516,144,556,2031,184,260,444,31,73,195,175,629,2227,573,1043,1960
Matteo Spagnolo,2024-10-12,356,790,1567,132,553,2194,184,184,444,31,37,195,163,590,2389,540,974,2011
Matteo Spagnolo,2024-10-13,356,790,1567,132,553,2194,196,276,444,33,77,195,165,630,2389,552,1066,2011
Matteo Spagnolo,2024-10-14,396,715,1607,150,472,2266,196,276,444,33,77,195,184,549,2461,592,991,2051
Matteo Spagnolo,2024-10-15,355,659,1534,121,402,2102,288,368,536,75,136,284,196,538,2386,643,1027,2070
Matteo Spagnolo,2024-10-16,309,623,1459,77,330,1926,288,368,536,75,136,284,152,466,2210,597,991,1995
Matteo Spagnolo,2024-10-17,275,619,1382,61,328,1700,384,464,632,131,209,386,191,537,2085,659,1083,2014
Matteo Spagnolo,2024-10-19,241,597,1258,39,316,1447,280,464,632,70,195,386,109,511,1832,521,1061,1890
Matteo Spagnolo,2024-10-20,241,597,1258,39,316,1422,276,472,628,69,198,383,108,515,1805,517,1069,1886
Matteo Spagnolo,2024-10-21,241,637,1298,48,369,1532,276,472,628,69,198,383,117,568,1915,517,1109,1926
Matteo Spagnolo,2024-10-22,308,663,1322,92,424,1639,184,472,628,29,198,383,122,623,2022,492,1135,1950
Matteo Spagnolo,2024-10-23,346,655,1377,135,419,1790,184,472,628,29,198,383,164,617,2173,530,1127,2005
Matteo Spagnolo,2024-10-24,350,625,1428,147,400,1942,328,712,868,52,356,599,199,756,2541,678,1337,2296
Tim Schneider,2024-08-20,120,120,120,6,28,52,0,0,0,0,0,0,6,28,52,120,120,120
Tim Schneider,2024-08-21,255,255,255,33,79,130,0,0,0,0,0,0,33,79,130,255,255,255
Tim Schneider,2024-08-22,390,390,390,78,148,226,0,0,0,0,0,0,78,148,226,390,390,390
Tim Schneider,2024-08-23,490,490,490,127,216,314,0,0,0,0,0,0,127,216,314,490,490,490
Tim Schneider,2024-08-24,550,550,550,171,270,380,0,0,0,0,0,0,171,270,380,550,550,550
Tim Schneider,2024-08-25,640,640,640,224,307,467,0,0,0,0,0,0,224,307,467,640,640,640
Tim Schneider,2024-08-27,640,760,760,243,327,616,0,0,0,0,0,0,243,327,616,640,760,760
Tim Schneider,2024-08-28,705,960,960,289,518,883,0,0,0,0,0,0,289,518,883,705,960,960
Tim Schneider,2024-08-30,595,1085,1085,202,651,1063,0,0,0,0,0,0,202,651,1063,595,1085,1085
Tim Schneider,2024-08-31,645,1195,1195,219,777,1231,0,0,0,0,0,0,219,777,1231,645,1195,1195
Tim Schneider,2024-09-01,555,1195,1195,167,777,1231,48,48,48,3,3,3,169,780,1234,603,1243,1243
Tim Schneider,2024-09-03,535,1175,1295,193,870,1256,48,48,48,3,3,3,195,872,1259,583,1223,1343
Tim Schneider,2024-09-04,455,1160,1415,146,847,1472,48,48,48,3,3,3,148,850,1474,503,1208,1463
Tim Schneider,2024-09-05,575,1145,1535,224,836,1704,48,48,48,3,3,3,227,839,1707,623,1193,1583
Tim Schneider,2024-09-06,555,1150,1640,216,840,1919,48,48,48,3,3,3,219,842,1922,603,1198,1688
Tim Schneider,2024-09-07,505,1150,1700,187,817,2040,128,128,128,17,17,17,203,833,2057,633,1278,1828
Tim Schneider,2024-09-09,610,1165,1805,268,862,2112,80,128,128,6,17,17,274,879,2128,690,1293,1933
Tim Schneider,2024-09-10,510,1045,1805,153,690,1967,80,128,128,6,17,17,159,706,1984,590,1173,1933
Tim Schneider,2024-09-11,390,845,1805,90,465,1967,80,128,128,6,17,17,95,481,1984,470,973,1933
Tim Schneider,2024-09-12,330,905,1865,73,552,2145,80,128,128,6,17,17,78,569,2161,410,1033,1993
Tim Schneider,2024-09-13,275,830,1915,61,506,2317,80,128,128,6,17,17,66,523,2334,355,958,2043
Tim Schneider,2024-09-15,215,720,1915,41,403,2317,0,80,128,0,6,17,41,409,2334,215,800,2043
Tim Schneider,2024-09-17,110,620,1795,13,260,2082,0,80,128,0,6,17,13,266,2099,110,700,1923
Tim Schneider,2024-09-18,110,500,1660,13,175,1793,0,80,128,0,6,17,13,181,1809,110,580,1788
Tim Schneider,2024-09-19,50,380,1525,3,106,1540,0,80,128,0,6,17,3,112,1557,50,460,1653
Tim Schneider,2024-09-20,0,275,1425,0,61,1354,0,80,128,0,6,17,0,66,1370,0,355,1553
Tim Schneider,2024-09-21,0,215,1365,0,41,1229,0,0,128,0,0,17,0,41,1245,0,215,1493
Tim Schneider,2024-09-22,0,215,1275,0,41,1097,0,0,128,0,0,17,0,41,1113,0,215,1403
Tim Schneider,2024-09-24,85,195,1240,5,35,1042,0,0,128,0,0,17,5,35,1058,85,195,1368
Tim Schneider,2024-09-25,188,298,1143,23,72,903,0,0,128,0,0,17,23,72,920,188,298,1271
Tim Schneider,2024-09-26,188,238,1143,23,43,903,0,0,128,0,0,17,23,43,920,188,238,1271
Tim Schneider,2024-09-27,188,188,1018,23,23,743,0,0,128,0,0,17,23,23,760,188,188,1146
Tim Schneider,2024-09-28,232,232,952,42,42,704,0,0,128,0,0,17,42,42,721,232,232,1080
Tim Schneider,2024-09-30,330,330,1050,66,66,798,0,0,80,0,0,6,66,66,804,330,330,1130
Tim Schneider,2024-10-01,319,404,1024,61,101,686,0,0,80,0,0,6,61,101,692,319,404,1104
Tim Schneider,2024-10-02,352,540,1040,109,232,811,0,0,80,0,0,6,109,232,817,352,540,1120
Tim Schneider,2024-10-03,403,591,971,137,272,719,0,0,80,0,0,6,137,272,724,403,591,1051
Tim Schneider,2024-10-04,403,591,866,137,272,589,480,480,560,34,34,78,171,305,667,883,1071,1426
Tim Schneider,2024-10-05,458,690,905,183,400,697,480,480,480,34,34,34,217,434,730,938,1170,1385
Tim Schneider,2024-10-06,458,690,905,183,400,697,480,480,480,34,34,34,217,434,730,938,1170,1385
Tim Schneider,2024-10-08,369,688,883,137,385,653,480,480,480,34,34,34,170,419,687,849,1168,1363
Tim Schneider,2024-10-09,329,681,979,105,429,852,480,480,480,34,34,34,139,463,885,809,1161,1459
Tim Schneider,2024-10-10,359,762,1000,129,533,880,480,480,480,34,34,34,163,567,914,839,1242,1480
Tim Schneider,2024-10-11,404,807,995,170,613,876,20,500,500,1,50,50,170,663,926,424,1307,1495
Tim Schneider,2024-10-12,356,814,1046,128,619,983,20,500,500,1,50,50,129,669,1033,376,1314,1546
Tim Schneider,2024-10-13,356,814,1046,128,619,983,28,508,508,1,61,61,130,680,1044,384,1322,1554
Tim Schneider,2024-10-14,441,801,1131,216,697,1210,28,508,508,1,61,61,217,758,1271,469,1309,1639
Tim Schneider,2024-10-15,400,769,1173,192,654,1290,84,564,564,12,118,118,204,772,1409,484,1333,1737
Tim Schneider,2024-10-16,354,683,1223,135,478,1382,84,564,564,12,118,118,146,597,1500,438,1247,1787
Tim Schneider,2024-10-17,320,679,1270,109,475,1473,144,624,624,33,187,187,142,663,1660,464,1303,1894
Tim Schneider,2024-10-18,315,719,1310,107,546,1598,124,144,624,25,33,187,132,580,1785,439,863,1934
Tim Schneider,2024-10-19,326,682,1372,101,457,1715,124,144,624,25,33,187,126,490,1902,450,826,1996
Tim Schneider,2024-10-20,326,682,1372,101,457,1715,172,200,680,40,56,238,141,513,1953,498,882,2052
Tim Schneider,2024-10-22,313,713,1401,88,542,1849,116,200,680,16,56,238,104,598,2087,429,913,2081
Tim Schneider,2024-10-23,351,705,1386,133,536,1927,116,200,680,16,56,238,150,592,2165,467,905,2066
Tim Schneider,2024-10-24,355,675,1437,146,506,2084,296,440,920,38,158,396,184,665,2479,651,1115,2357
Trevion Williams,2024-08-20,120,120,120,5,5,5,0,0,0,0,0,0,5,5,5,120,120,120
Trevion Williams,2024-08-21,255,255,255,31,31,31,0,0,0,0,0,0,31,31,31,255,255,255
Trevion Williams,2024-08-22,390,390,390,66,66,66,0,0,0,0,0,0,66,66,66,390,390,390
Trevion Williams,2024-08-23,490,490,490,123,123,123,0,0,0,0,0,0,123,123,123,490,490,490
Trevion Williams,2024-08-24,610,610,610,201,201,201,0,0,0,0,0,0,201,201,201,610,610,610
Trevion Williams,2024-08-25,700,700,700,273,273,273,0,0,0,0,0,0,273,273,273,700,700,700
Trevion Williams,2024-08-27,580,700,700,203,273,273,0,0,0,0,0,0,203,273,273,580,700,700
Trevion Williams,2024-08-28,445,700,700,120,273,273,0,0,0,0,0,0,120,273,273,445,700,700
Trevion Williams,2024-08-30,335,825,825,54,338,338,0,0,0,0,0,0,54,338,338,335,825,825
Trevion Williams,2024-08-31,325,935,935,46,439,439,0,0,0,0,0,0,46,439,439,325,935,935
Trevion Williams,2024-09-01,235,935,935,19,439,439,240,240,240,17,17,17,36,456,456,475,1175,1175
Trevion Williams,2024-09-03,335,915,1035,74,522,631,240,240,240,17,17,17,91,538,648,575,1155,1275
Trevion Williams,2024-09-04,455,900,1155,132,504,785,240,240,240,17,17,17,149,521,802,695,1140,1395
Trevion Williams,2024-09-05,575,885,1275,207,513,956,240,240,240,17,17,17,224,530,973,815,1125,1515
Trevion Williams,2024-09-06,555,890,1380,222,498,1118,240,240,240,17,17,17,239,515,1135,795,1130,1620
Trevion Williams,2024-09-07,505,830,1440,187,423,1210,344,344,344,45,45,45,232,468,1254,849,1174,1784
Trevion Williams,2024-09-09,610,845,1545,275,448,1421,104,344,344,6,45,45,281,493,1466,714,1189,1889
Trevion Williams,2024-09-10,600,935,1635,240,580,1651,104,344,344,6,45,45,246,624,1696,704,1279,1979
Trevion Williams,2024-09-11,480,935,1635,197,655,1782,104,344,344,6,45,45,203,699,1827,584,1279,1979
Trevion Williams,2024-09-12,420,995,1695,155,726,1898,200,440,440,26,88,88,181,814,1986,620,1435,2135
Trevion Williams,2024-09-13,365,920,1745,124,681,2007,292,532,532,64,154,154,188,835,2161,657,1452,2277
Trevion Williams,2024-09-15,305,810,1745,95,551,2007,276,380,620,63,110,223,158,661,2230,581,1190,2365
Trevion Williams,2024-09-17,175,775,1690,35,465,1977,276,380,620,63,110,223,98,575,2201,451,1155,2310
Trevion Williams,2024-09-18,300,780,1680,60,476,1966,276,380,620,63,110,223,123,586,2189,576,1160,2300
Trevion Williams,2024-09-19,354,774,1659,85,472,1974,180,380,620,29,110,223,114,582,2197,534,1154,2279
Trevion Williams,2024-09-20,416,781,1671,121,492,1988,88,380,620,6,110,223,127,602,2212,504,1161,2291
Trevion Williams,2024-09-21,490,795,1625,186,549,1950,88,276,620,6,63,223,192,612,2173,578,1071,2245
Trevion Williams,2024-09-22,490,795,1535,196,564,1781,92,368,712,8,118,320,204,682,2101,582,1163,2247
Trevion Williams,2024-09-24,510,685,1620,204,411,1976,92,368,712,8,118,320,212,529,2297,602,1053,2332
Trevion Williams,2024-09-25,488,788,1723,181,449,2188,92,368,712,8,118,320,189,567,2509,580,1156,2435
Trevion Williams,2024-09-26,464,818,1813,167,491,2411,92,272,712,8,68,320,175,559,2732,556,1090,2525
Trevion Williams,2024-09-27,352,768,1688,99,438,2211,92,180,712,8,29,320,107,467,2532,444,948,2400
Trevion Williams,2024-09-28,322,812,1622,81,512,2125,180,268,800,27,59,408,108,571,2533,502,1080,2422
Trevion Williams,2024-09-30,437,927,1737,127,640,2380,88,180,560,5,27,246,132,667,2626,525,1107,2297
Trevion Williams,2024-10-01,450,960,1735,131,662,2238,88,180,560,5,27,246,136,689,2485,538,1140,2295
Trevion Williams,2024-10-02,423,911,1691,123,601,2148,88,180,560,5,27,246,128,628,2394,511,1091,2251
Trevion Williams,2024-10-03,384,848,1622,100,526,1995,88,180,560,5,27,246,105,553,2241,472,1028,2182
Trevion Williams,2024-10-04,384,736,1517,100,397,1775,184,276,656,24,61,335,124,458,2109,568,1012,2173
Trevion Williams,2024-10-05,424,746,1541,106,373,1834,96,276,552,7,61,248,113,434,2082,520,1022,2093
Trevion Williams,2024-10-06,424,746,1541,106,358,1834,188,276,644,28,58,341,134,416,2175,612,1022,2185
Trevion Williams,2024-10-08,294,744,1429,56,357,1543,188,276,644,28,58,341,84,415,1885,482,1020,2073
Trevion Williams,2024-10-09,299,722,1510,66,368,1631,188,276,644,28,58,341,94,426,1972,487,998,2154
Trevion Williams,2024-10-10,329,713,1531,86,371,1715,188,276,548,28,58,252,114,429,1967,517,989,2079
Trevion Williams,2024-10-11,374,758,1526,120,440,1755,172,356,536,28,103,241,147,543,1996,546,1114,2062
Trevion Williams,2024-10-12,341,765,1577,113,444,1908,172,268,536,28,62,241,140,505,2149,513,1033,2113
Trevion Williams,2024-10-13,341,765,1577,113,444,1908,172,360,540,26,108,243,138,552,2151,513,1125,2117
Trevion Williams,2024-10-14,381,690,1617,137,380,2005,172,360,540,26,108,243,163,488,2248,553,1050,2157
Trevion Williams,2024-10-15,340,634,1594,112,330,1929,256,444,624,56,164,324,169,494,2253,596,1078,2218
Trevion Williams,2024-10-16,309,608,1519,87,304,1762,256,444,624,56,164,324,143,468,2087,565,1052,2143
Trevion Williams,2024-10-17,275,604,1452,66,302,1626,352,540,720,102,238,425,168,540,2051,627,1144,2172
Trevion Williams,2024-10-19,179,520,1266,21,234,1203,272,444,720,57,164,425,79,398,1628,451,964,1986
Trevion Williams,2024-10-20,179,520,1266,21,234,1177,180,352,628,25,102,314,47,336,1491,359,872,1894
Trevion Williams,2024-10-22,97,437,1181,6,170,1027,96,352,628,7,102,314,13,273,1341,193,789,1809
Trevion Williams,2024-10-23,47,356,1078,1,110,884,96,352,628,7,102,314,8,212,1198,143,708,1706
Trevion Williams,2024-10-24,0,275,988,0,66,751,0,352,628,0,102,314,0,168,1065,0,627,1616
Will McDowell-White,2024-08-21,135,135,135,8,8,8,0,0,0,0,0,0,8,8,8,135,135,135
Will McDowell-White,2024-08-22,270,270,270,35,35,35,0,0,0,0,0,0,35,35,35,270,270,270
Will McDowell-White,2024-08-23,370,370,370,78,78,78,0,0,0,0,0,0,78,78,78,370,370,370
Will McDowell-White,2024-08-24,490,490,490,147,147,147,0,0,0,0,0,0,147,147,147,490,490,490
Will McDowell-White,2024-08-25,670,670,670,268,268,268,0,0,0,0,0,0,268,268,268,670,670,670
Will McDowell-White,2024-08-26,670,670,670,268,268,268,0,0,0,0,0,0,268,268,268,670,670,670
Will McDowell-White,2024-08-27,790,790,790,379,379,379,0,0,0,0,0,0,379,379,379,790,790,790
Will McDowell-White,2024-08-28,855,990,990,453,584,584,0,0,0,0,0,0,453,584,584,855,990,990
Will McDowell-White,2024-08-30,745,1115,1115,335,736,736,0,0,0,0,0,0,335,736,736,745,1115,1115
Will McDowell-White,2024-08-31,735,1225,1225,301,870,870,0,0,0,0,0,0,301,870,870,735,1225,1225
Will McDowell-White,2024-09-01,555,1225,1225,172,870,870,72,72,72,6,6,6,179,876,876,627,1297,1297
Will McDowell-White,2024-09-03,535,1325,1325,209,1153,1153,72,72,72,6,6,6,215,1159,1159,607,1397,1397
Will McDowell-White,2024-09-04,455,1310,1445,159,1153,1358,72,72,72,6,6,6,166,1159,1365,527,1382,1517
Will McDowell-White,2024-09-05,575,1295,1565,236,1127,1565,72,72,72,6,6,6,242,1133,1571,647,1367,1637
Will McDowell-White,2024-09-06,555,1300,1670,222,1105,1770,72,72,72,6,6,6,228,1111,1777,627,1372,1742
Will McDowell-White,2024-09-07,505,1240,1730,192,980,1886,132,132,132,22,22,22,214,1002,1908,637,1372,1862
Will McDowell-White,2024-09-09,610,1165,1835,275,885,2129,60,132,132,5,22,22,279,908,2151,670,1297,1967
Will McDowell-White,2024-09-10,600,1135,1925,216,851,2368,60,132,132,5,22,22,221,874,2390,660,1267,2057
Will McDowell-White,2024-09-11,480,935,1925,173,664,2503,60,132,132,5,22,22,178,686,2525,540,1067,2057
Will McDowell-White,2024-09-12,420,995,1985,139,736,2640,156,228,228,27,59,59,165,796,2699,576,1223,2213
Will McDowell-White,2024-09-13,365,920,2035,110,644,2768,240,312,312,60,106,106,170,750,2874,605,1232,2347
Will McDowell-White,2024-09-15,305,810,2035,82,527,2768,248,308,380,60,99,156,142,625,2923,553,1118,2415
Will McDowell-White,2024-09-17,225,825,2150,45,462,3075,248,308,380,60,99,156,105,561,3230,473,1133,2530
Will McDowell-White,2024-09-18,350,830,2140,74,473,3103,248,308,380,60,99,156,133,572,3259,598,1138,2520
Will McDowell-White,2024-09-19,404,824,2119,93,461,3030,152,308,380,23,99,156,116,560,3186,556,1132,2499
Will McDowell-White,2024-09-20,466,831,2131,130,482,3047,68,308,380,5,99,156,135,581,3203,534,1139,2511
Will McDowell-White,2024-09-21,540,845,2085,189,524,2940,68,248,380,5,60,156,194,583,3096,608,1093,2465
Will McDowell-White,2024-09-22,540,845,1905,189,524,2496,80,328,460,6,105,225,195,629,2721,620,1173,2365
Will McDowell-White,2024-09-24,510,735,1870,179,404,2431,80,328,460,6,105,225,185,509,2656,590,1063,2330
Will McDowell-White,2024-09-25,488,838,1773,166,461,2234,80,328,460,6,105,225,172,566,2459,568,1166,2233
Will McDowell-White,2024-09-26,464,868,1863,172,521,2496,80,232,460,6,53,225,178,574,2722,544,1100,2323
Will McDowell-White,2024-09-27,417,883,1803,150,565,2416,80,148,460,6,22,225,157,587,2641,497,1031,2263
Will McDowell-White,2024-09-28,387,927,1737,135,649,2345,140,208,520,22,48,296,158,697,2641,527,1135,2257
Will McDowell-White,2024-09-30,387,927,1737,135,649,2345,60,140,448,5,22,215,140,671,2560,447,1067,2185
Will McDowell-White,2024-10-01,400,910,1735,144,646,2203,60,140,448,5,22,215,149,669,2418,460,1050,2183
Will McDowell-White,2024-10-02,373,861,1691,131,594,2131,60,140,448,5,22,215,135,616,2346,433,1001,2139
Will McDowell-White,2024-10-03,334,798,1622,100,535,1995,60,140,448,5,22,215,105,557,2210,394,938,2070
Will McDowell-White,2024-10-04,269,686,1517,62,405,1775,120,200,508,19,48,284,81,453,2059,389,886,2025
Will McDowell-White,2024-10-05,309,696,1541,68,397,1834,60,200,448,5,48,215,73,445,2049,369,896,1989
Will McDowell-White,2024-10-06,309,696,1541,68,397,1834,104,164,492,16,38,271,84,434,2104,413,860,2033
Will McDowell-White,2024-10-08,294,694,1429,56,382,1572,104,164,492,16,38,271,71,419,1843,398,858,1921
Will McDowell-White,2024-10-09,319,692,1530,89,436,1805,104,164,492,16,38,271,105,474,2076,423,856,2022
Will McDowell-White,2024-10-10,349,683,1551,105,410,1861,104,164,396,16,38,182,120,448,2043,453,847,1947
Will McDowell-White,2024-10-11,394,663,1546,142,391,1902,96,216,364,15,69,171,157,460,2073,490,879,1910
Will McDowell-White,2024-10-12,361,670,1597,134,395,2060,96,156,364,15,37,171,149,433,2231,457,826,1961
Will McDowell-White,2024-10-13,361,670,1597,134,395,2060,108,212,352,18,68,169,152,463,2229,469,882,1949
Will McDowell-White,2024-10-14,401,710,1637,156,433,2144,108,212,352,18,68,169,175,501,2313,509,922,1989
Will McDowell-White,2024-10-15,360,654,1564,133,366,1986,108,212,352,18,68,169,152,434,2155,468,866,1916
Will McDowell-White,2024-10-16,309,628,1489,77,333,1817,108,212,352,18,68,169,96,401,1986,417,840,1841
Will McDowell-White,2024-10-17,275,624,1422,63,331,1706,168,272,412,42,109,231,105,440,1937,443,896,1834
Will McDowell-White,2024-10-19,241,602,1298,36,313,1415,116,212,412,19,68,231,55,381,1646,357,814,1710
Will McDowell-White,2024-10-20,241,602,1298,36,313,1415,116,224,388,17,72,213,54,385,1628,357,826,1686
Will McDowell-White,2024-10-22,258,618,1312,41,328,1417,116,224,388,17,72,213,59,399,1630,374,842,1700
Will McDowell-White,2024-10-23,281,590,1282,53,260,1372,116,224,388,17,72,213,71,331,1585,397,814,1670
Will McDowell-White,2024-10-24,285,560,1243,63,252,1305,296,464,628,44,186,396,107,438,1701,581,1024,1871
Yanni Wetzell,2024-08-20,0,0,0,0,0,0,0,0,0,0,0,0,0,0,0,0,0,0
Yanni Wetzell,2024-08-21,135,135,135,9,9,9,0,0,0,0,0,0,9,9,9,135,135,135
Yanni Wetzell,2024-08-22,270,270,270,41,41,41,0,0,0,0,0,0,41,41,41,270,270,270
Yanni Wetzell,2024-08-23,370,370,370,85,85,85,0,0,0,0,0,0,85,85,85,370,370,370
Yanni Wetzell,2024-08-24,490,490,490,157,157,157,0,0,0,0,0,0,157,157,157,490,490,490
Yanni Wetzell,2024-08-25,670,670,670,302,302,302,0,0,0,0,0,0,302,302,302,670,670,670
Yanni Wetzell,2024-08-27,790,790,790,419,419,419,0,0,0,0,0,0,419,419,419,790,790,790
Yanni Wetzell,2024-08-28,855,990,990,496,644,644,0,0,0,0,0,0,496,644,644,855,990,990
Yanni Wetzell,2024-08-30,745,1115,1115,380,825,825,0,0,0,0,0,0,380,825,825,745,1115,1115
Yanni Wetzell,2024-08-31,735,1225,1225,368,1005,1005,0,0,0,0,0,0,368,1005,1005,735,1225,1225
Yanni Wetzell,2024-09-01,555,1225,1225,205,1005,1005,76,76,76,7,7,7,212,1011,1011,631,1301,1301
Yanni Wetzell,2024-09-03,535,1325,1325,219,1246,1246,76,76,76,7,7,7,226,1252,1252,611,1401,1401
Yanni Wetzell,2024-09-04,455,1310,1445,177,1271,1503,76,76,76,7,7,7,184,1278,1510,531,1386,1521
Yanni Wetzell,2024-09-05,455,1175,1445,177,1046,1503,76,76,76,7,7,7,184,1053,1510,531,1251,1521
Yanni Wetzell,2024-09-06,330,1075,1445,99,871,1503,76,76,76,7,7,7,106,878,1510,406,1151,1521
Yanni Wetzell,2024-09-07,220,955,1445,48,688,1503,76,76,76,7,7,7,55,694,1510,296,1031,1521
Yanni Wetzell,2024-09-09,310,865,1535,90,571,1704,0,76,76,0,7,7,90,578,1711,310,941,1611
Yanni Wetzell,2024-09-10,210,745,1535,36,432,1704,0,76,76,0,7,7,36,439,1711,210,821,1611
Yanni Wetzell,2024-09-11,90,545,1535,13,289,1811,0,76,76,0,7,7,13,296,1818,90,621,1611
Yanni Wetzell,2024-09-12,150,605,1595,26,339,1930,72,148,148,6,27,27,32,365,1957,222,753,1743
Yanni Wetzell,2024-09-13,200,530,1645,48,286,2106,132,208,208,21,52,52,69,338,2158,332,738,1853
Yanni Wetzell,2024-09-15,200,420,1645,48,193,2106,208,208,284,52,52,97,100,245,2202,408,628,1929
Yanni Wetzell,2024-09-17,225,435,1760,54,178,2376,208,208,284,52,52,97,106,230,2473,433,643,2044
Yanni Wetzell,2024-09-18,350,440,1750,95,180,2415,208,208,284,52,52,97,147,232,2512,558,648,2034
Yanni Wetzell,2024-09-19,404,554,1729,125,266,2369,136,208,284,22,52,97,147,318,2465,540,762,2013
Yanni Wetzell,2024-09-20,466,666,1741,154,380,2403,76,208,284,7,52,97,161,432,2499,542,874,2025
Yanni Wetzell,2024-09-21,540,740,1695,205,459,2271,76,208,284,7,52,97,212,511,2368,616,948,1979
Yanni Wetzell,2024-09-22,540,740,1515,205,459,1833,84,292,368,7,96,155,212,555,1988,624,1032,1883
Yanni Wetzell,2024-09-24,510,735,1480,199,463,1791,84,292,368,7,96,155,206,559,1945,594,1027,1848
Yanni Wetzell,2024-09-25,488,838,1383,185,545,1632,84,292,368,7,96,155,192,641,1787,572,1130,1751
Yanni Wetzell,2024-09-26,443,847,1452,164,576,1800,84,220,368,7,53,155,171,629,1955,527,1067,1820
Yanni Wetzell,2024-09-27,396,862,1392,131,569,1670,84,160,368,7,27,155,137,596,1825,480,1022,1760
Yanni Wetzell,2024-09-28,366,906,1326,128,661,1578,176,252,460,30,66,235,158,727,1813,542,1158,1786
Yanni Wetzell,2024-09-30,481,1021,1441,197,807,1801,92,176,384,8,30,161,205,837,1963,573,1197,1825
Yanni Wetzell,2024-10-01,494,1004,1439,203,803,1741,92,176,384,8,30,161,211,833,1902,586,1180,1823
Yanni Wetzell,2024-10-02,467,955,1395,177,726,1632,92,176,384,8,30,161,186,756,1793,559,1131,1779
Yanni Wetzell,2024-10-03,449,892,1446,157,642,1735,92,176,384,8,30,161,165,672,1896,541,1068,1830
Yanni Wetzell,2024-10-04,384,780,1446,115,491,1735,168,252,460,29,63,230,144,554,1965,552,1032,1906
Yanni Wetzell,2024-10-05,424,790,1530,123,506,1928,76,252,460,6,63,230,129,569,2158,500,1042,1990
Yanni Wetzell,2024-10-06,424,790,1530,123,506,1928,192,284,576,33,74,340,156,579,2268,616,1074,2106
Yanni Wetzell,2024-10-08,294,788,1523,59,481,1889,192,284,576,33,74,340,91,555,2228,486,1072,2099
Yanni Wetzell,2024-10-09,218,685,1523,31,356,1782,192,284,576,33,74,340,63,430,2122,410,969,2099
Yanni Wetzell,2024-10-10,248,697,1544,40,355,1837,192,284,504,33,74,252,72,429,2089,440,981,2048
Yanni Wetzell,2024-10-11,293,677,1539,67,359,1831,196,364,524,35,127,272,103,486,2104,489,1041,2063
Yanni Wetzell,2024-10-12,260,684,1590,62,363,2003,196,272,524,35,71,272,98,433,2276,456,956,2114
Yanni Wetzell,2024-10-13,260,684,1590,62,363,2003,180,372,548,32,130,285,95,493,2288,440,1056,2138
Yanni Wetzell,2024-10-14,300,609,1630,75,292,2070,180,372,548,32,130,285,107,423,2355,480,981,2178
Yanni Wetzell,2024-10-15,259,553,1557,60,238,1915,268,460,636,72,202,388,132,440,2303,527,1013,2193
Yanni Wetzell,2024-10-16,309,527,1482,80,211,1719,268,460,636,72,202,388,153,413,2107,577,987,2118
Yanni Wetzell,2024-10-17,275,523,1415,66,209,1585,352,544,720,123,283,497,189,492,2082,627,1067,2135
Yanni Wetzell,2024-10-19,241,501,1291,36,195,1330,272,468,720,71,206,497,107,401,1827,513,969,2011
Yanni Wetzell,2024-10-20,241,501,1291,36,195,1330,264,444,728,71,200,517,107,395,1847,505,945,2019
Yanni Wetzell,2024-10-22,258,517,1305,49,217,1344,176,444,728,32,200,517,81,417,1861,434,961,2033
Yanni Wetzell,2024-10-23,281,590,1275,65,289,1288,176,444,728,32,200,517,96,489,1805,457,1034,2003
Yanni Wetzell,2024-10-24,285,560,1257,74,280,1270,332,684,968,63,369,774,137,649,2044,617,1244,2225
Ziga Samar,2024-08-20,0,0,0,0,0,0,0,0,0,0,0,0,0,0,0,0,0,0
Ziga Samar,2024-08-21,0,0,0,0,0,0,0,0,0,0,0,0,0,0,0,0,0,0
Ziga Samar,2024-08-22,0,0,0,0,0,0,0,0,0,0,0,0,0,0,0,0,0,0
Ziga Samar,2024-08-23,0,0,0,0,0,0,0,0,0,0,0,0,0,0,0,0,0,0
Ziga Samar,2024-08-24,0,0,0,0,0,0,0,0,0,0,0,0,0,0,0,0,0,0
Ziga Samar,2024-08-25,0,0,0,0,0,0,0,0,0,0,0,0,0,0,0,0,0,0
Ziga Samar,2024-08-26,0,0,0,0,0,0,0,0,0,0,0,0,0,0,0,0,0,0
Ziga Samar,2024-08-27,0,0,0,0,0,0,0,0,0,0,0,0,0,0,0,0,0,0
Ziga Samar,2024-08-28,0,0,0,0,0,0,0,0,0,0,0,0,0,0,0,0,0,0
Ziga Samar,2024-08-30,0,0,0,0,0,0,0,0,0,0,0,0,0,0,0,0,0,0
Ziga Samar,2024-08-31,0,0,0,0,0,0,0,0,0,0,0,0,0,0,0,0,0,0
Ziga Samar,2024-09-01,0,0,0,0,0,0,0,0,0,0,0,0,0,0,0,0,0,0
Ziga Samar,2024-09-03,0,0,0,0,0,0,0,0,0,0,0,0,0,0,0,0,0,0
Ziga Samar,2024-09-04,0,0,0,0,0,0,0,0,0,0,0,0,0,0,0,0,0,0
Ziga Samar,2024-09-05,0,0,0,0,0,0,0,0,0,0,0,0,0,0,0,0,0,0
Ziga Samar,2024-09-06,0,0,0,0,0,0,0,0,0,0,0,0,0,0,0,0,0,0
Ziga Samar,2024-09-07,0,0,0,0,0,0,0,0,0,0,0,0,0,0,0,0,0,0
Ziga Samar,2024-09-09,0,0,0,0,0,0,0,0,0,0,0,0,0,0,0,0,0,0
Ziga Samar,2024-09-10,0,0,0,0,0,0,0,0,0,0,0,0,0,0,0,0,0,0
Ziga Samar,2024-09-11,45,45,45,,,,0,0,0,0,0,0,,,,45,45,45
Ziga Samar,2024-09-12,45,45,45,,,,0,0,0,0,0,0,,,,45,45,45
Ziga Samar,2024-09-13,95,95,95,,,,0,0,0,0,0,0,,,,95,95,95
Ziga Samar,2024-09-14,155,155,155,,,,0,0,0,0,0,0,,,,155,155,155
Ziga Samar,2024-09-15,215,215,215,,,,0,0,0,0,0,0,,,,215,215,215
Ziga Samar,2024-09-17,215,215,215,,,,0,0,0,0,0,0,,,,215,215,215
Ziga Samar,2024-09-18,170,215,215,15,,,0,0,0,0,0,0,15,,,170,215,215
Ziga Samar,2024-09-19,170,215,215,15,,,0,0,0,0,0,0,15,,,170,215,215
Ziga Samar,2024-09-20,120,215,215,7,,,0,0,0,0,0,0,7,,,120,215,215
Ziga Samar,2024-09-21,60,215,215,2,,,0,0,0,0,0,0,2,,,60,215,215
Ziga Samar,2024-09-22,0,215,215,0,,,0,0,0,0,0,0,0,,,0,215,215
Ziga Samar,2024-09-24,0,215,215,0,,,0,0,0,0,0,0,0,,,0,215,215
Ziga Samar,2024-09-25,0,170,215,0,20,,0,0,0,0,0,0,0,20,,0,170,215
Ziga Samar,2024-09-26,46,216,261,2,30,,0,0,0,0,0,0,2,30,,46,216,261
Ziga Samar,2024-09-27,102,222,317,11,38,,0,0,0,0,0,0,11,38,,102,222,317
Ziga Samar,2024-09-28,146,206,361,22,37,,0,0,0,0,0,0,22,37,,146,206,361
Ziga Samar,2024-09-30,255,255,470,51,51,,0,0,0,0,0,0,51,51,,255,255,470
Ziga Samar,2024-10-01,329,329,544,76,86,,0,0,0,0,0,0,76,86,,329,329,544
Ziga Samar,2024-10-02,415,415,630,125,137,,0,0,0,0,0,0,125,137,,415,415,630
Ziga Samar,2024-10-03,420,466,681,130,168,,0,0,0,0,0,0,130,168,,420,466,681
Ziga Samar,2024-10-04,364,466,681,91,168,,0,0,0,0,0,0,91,168,,364,466,681
Ziga Samar,2024-10-05,404,550,765,105,226,,0,0,0,0,0,0,105,226,,404,550,765
Ziga Samar,2024-10-06,404,550,765,105,226,,0,0,0,0,0,0,105,226,,404,550,765
Ziga Samar,2024-10-08,304,633,848,64,279,,0,0,0,0,0,0,64,279,,304,633,848
Ziga Samar,2024-10-09,299,714,884,63,364,557,0,0,0,0,0,0,63,364,557,299,714,884
Ziga Samar,2024-10-10,329,749,965,79,412,666,0,0,0,0,0,0,79,412,666,329,749,965
Ziga Samar,2024-10-11,329,693,915,79,340,604,0,0,0,0,0,0,79,340,604,329,693,915
Ziga Samar,2024-10-12,245,649,855,47,292,539,0,0,0,0,0,0,47,292,539,245,649,855
Ziga Samar,2024-10-13,305,709,855,67,340,539,0,0,0,0,0,0,67,340,539,305,709,855
Ziga Samar,2024-10-14,345,640,895,79,282,573,0,0,0,0,0,0,79,282,573,345,640,895
Ziga Samar,2024-10-15,304,608,937,61,249,628,0,0,0,0,0,0,61,249,628,304,608,937
Ziga Samar,2024-10-16,273,572,987,44,212,691,0,0,0,0,0,0,44,212,691,273,572,987
Ziga Samar,2024-10-17,239,568,1034,31,210,755,0,0,0,0,0,0,31,210,755,239,568,1034
Ziga Samar,2024-10-19,301,546,1096,51,197,844,0,0,0,0,0,0,51,197,844,301,546,1096
Ziga Samar,2024-10-20,241,546,1096,34,197,844,0,0,0,0,0,0,34,197,844,241,546,1096
Ziga Samar,2024-10-22,258,562,1195,36,191,932,0,0,0,0,0,0,36,191,932,258,562,1195
Ziga Samar,2024-10-23,281,554,1268,51,188,1078,0,0,0,0,0,0,51,188,1078,281,554,1268
Ziga Samar,2024-10-24,285,524,1273,54,168,1108,240,240,240,7,7,7,61,175,1115,525,764,1513